The Guardian
An Interactive Fiction by Sari Stissi
Release 1 / Serial number 200517 / Inform 7 build 6M62 (I6/v6.33 lib 6/12N) SD

You are a woman in ancient Greece on the Island of Sarpedon and you have no idea who you are. What happened? Who are you really?

You are encouraged to check the help list to know the commands you will need for this game and how to use them. Also examine is a very useful command in this game. 
And you are encouraged to look at the top of your screen where you can see a status line. It's a different color than the rest of the page and you can see where your exits are, the name of the room you're in and a reminder for how to access the help list. 
The Exits are abbreviated so: 
N is North 
S is South 
E is East 
W is West 
NW is Northwest 
NE is Northeast 
SW is Southwest 
SE is Southest 
D is Down 
U is Up 
Consult the help list for more info!

Town Center
You wake up not quite being able to remember anything from before this moment. All you remember is that you're Greek and you live on an island called Sarpedon. You look around you and notice dirt roads and beautiful foliage all around and a calmly flowing river to the north. The mountains near the northeast frame this beautiful landscape and you can sort of see some kind of buildings near the east. To the west you hear the bustling noise of what is most likely people trading, and to the south you see the architectural marvel of the temple of Athena.

There's a lyre laying against a wall. Calling out to you to play it since its owner is nowhere to be found.

Specifically among the foliage, you spot an apple tree with delicious apples ripe for the picking! Maybe one will fall soon.

Behind a corner you spot a hole in the ground that you can probably fit down into.

>go west
Agora
You walk into a bustling marketplace but quickly realize that you don't have anything to trade with! Maybe you can find something back in the Town Center.

>go east
Town Center
You're back to the beautiful courtyard dirt roads, beautiful foliage, river near the north, mountains near the northeast, some kind of buildings near the east, the bustling marketplace near the west, and the marvelous Temple of Athena to the south

There's a lyre laying against a wall. Calling out to you to play it since its owner is nowhere to be found.

Specifically among the foliage, you spot an apple tree with delicious apples ripe for the picking! Maybe one will fall soon.

Behind a corner you spot a hole in the ground that you can probably fit down into.

>look
Town Center
You wake up not quite being able to remember anything from before this moment. You look around you and notice dirt roads and beauitful foliage all around and a calmly flowing river to the north. The mountains near the northeast frame this beautiful landscape and you can sort of see some kind of buildings near the east. To the west you hear the bustling noise of what is most likely people trading.

There's a lyre laying against a wall. Calling out to you to play it since its owner is nowhere to be found.

Specifically among the foliage, you spot an apple tree with delicious apples ripe for the picking! Maybe one will fall soon.

Behind a corner you spot a hole in the ground that you can probably fit down into.

>play lyre
You play a beautiful melody and even sing a bit. It was so touching that some towns folk have given you a couple pieces of gold. You might as well take the coins and head towards the marketplace!

>take gold
You can't see any such thing.

>look
Town Center
You wake up not quite being able to remember anything from before this moment. You look around you and notice dirt roads and beauitful foliage all around and a calmly flowing river to the north. The mountains near the northeast frame this beautiful landscape and you can sort of see some kind of buildings near the east. To the west you hear the bustling noise of what is most likely people trading.

On the ground in front of your feet you can see gold coins tossed at you from when you played the lyre.

There's a lyre laying against a wall. Calling out to you to play it since its owner is nowhere to be found.

Specifically among the foliage, you spot an apple tree with delicious apples ripe for the picking! Maybe one will fall soon.

Behind a corner you spot a hole in the ground that you can probably fit down into.

>take coins
Now the coins are in your inventory (i).

>go west
Agora
You walk into a bustling marketplace with three major vendors. Hopefully you can find some useful items here. There seem to be three pretty well established vendors here to the north, west, and south.

* * *

>go east
Town Center
You're back to the beautiful courtyard dirt roads, beautiful foliage, river near the north, mountains near the northeast, some kind of buildings near the east, the bustling marketplace near the west, and the marvelous Temple of Athena to the south

There's a lyre laying against a wall. Calling out to you to play it since its owner is nowhere to be found.

Specifically among the foliage, you spot an apple tree with delicious apples ripe for the picking! Maybe one will fall soon.

Behind a corner you spot a hole in the ground that you can probably fit down into.

>go west
Agora
You walk into a bustling marketplace but quickly realize that you don't have anything to trade with! Maybe you can find something back in the Town Center.

>go east
Town Center
You're back to the beautiful courtyard dirt roads, beautiful foliage, river near the north, mountains near the northeast, some kind of buildings near the east, the bustling marketplace near the west, and the marvelous Temple of Athena to the south. It seems like something is different since the last time you were here.

One of the beautiful ripe apples fell down! Now you can take it.

There's a lyre laying against a wall. Calling out to you to play it since its owner is nowhere to be found.

Specifically among the foliage, you spot an apple tree with delicious apples ripe for the picking! Maybe one will fall soon.

Behind a corner you spot a hole in the ground that you can probably fit down into.

>take fallen apple
You now have an apple in your inventory (i).

>i
You are carrying:
  a fallen apple: 1

>play lyre
You play a beautiful melody and even sing a bit. It was so touching that some towns folk have given you a couple pieces of gold, which will probably only get you three things at the marketplace. You might as well take the coins and head towards there!

>take coins
Now the coins are in your inventory (i).

>i
You are carrying:
  a sack of coins
  a fallen apple: 1

>go east
This appears to be a gated community of sorts and the guard won't let you through with out the proper documents.

>look
Town Center
You're back to the beautiful courtyard dirt roads, beautiful foliage, river near the north, mountains near the northeast, some kind of buildings near the east, the bustling marketplace near the west, and the marvelous Temple of Athena to the south. It seems like something is different since the last time you were here.

There's a lyre laying against a wall. Calling out to you to play it since its owner is nowhere to be found.

Specifically among the foliage, you spot an apple tree with delicious apples ripe for the picking! Maybe one will fall soon.

Behind a corner you spot a hole in the ground that you can probably fit down into.

>go west
Agora
You walk into a bustling marketplace with three major vendors. Hopefully you can find some useful items here. There seem to be three pretty well established vendors here to the north, west, and south.

>go north
Vendor 1
You walk up to a stand where a burly man and his wife show you all the neat woodworking and ceramic items they've made and have to sell. Well at least you assume the small, toned lady made some of these items. You're not actually sure. There are many beautiful wooden sculptures here that you don't think the burly man hand the patience or delicacy to make, but he treats the woman like a lowly shop hand. You wish you could make her situation better. Maybe buying something of hers would be good.

You can see plates, axes, knives, pots, vases and large vessels here.

>x knives
You're not very fond of weapons, but the knives catch your eyes because they're breathtaking. You walk a bit closer to them and you can see the reflection of the woman perfectly and colors dance across her skin. You might as well be entraced. These might even be made from gems and not just metal. It looks like a type of ceremonial knife.

>x large vessels
You're intrigued by the large vessels try to see if you can find something of use, so you flag the woman over.

The woman comes up to you and points out that hidden small-ish boat behind some large vases and fishing boats. "I made this boat myself!" she says. She looks around and makes sure her husband is occupied with something else and whispers, "My husband over there doesn't like when I make things like he does, but I've always been drawn to it. I think once I sell it he won't be as irate anymore. Would you like to buy it? I'll accept 3 bundles of wheat. It would really mean a lot to me!"

>buy boat
You need to get wheat first!

>help
Welcome to the Help List!

This is a list of commands that you can type in that would be useful to you in the game. If you're unsure of how to do something, or stuck at a particular point, try some of these commands and you may get some hints.

The format of this list will be  <Command>: <what the command does>. 
<object> means replace that with the actual name of the object in the command. 
<person> means replace that with the name of a person that you meet in the command. etc.

-look: will redescribe the room/place you're in and the things in it. 
-examine (x for short): will take a closer look at an object in the room/place. 
-play <object>: if the object is an instrument, this command allows you to play it. 
-take <object>: if you can take an object and carry it with you, this command will put it in your inventory so that you can keep the object on your person. You can also buy items buy using the take command. As an alternative you can use the but command. 
-buy <object>: this allows you to buy wares from vendors. You can also use the take command. 
-drop <object>: will remove an object from your inventory and into the room/place you're in. 
-inventory (i for short): will show you all the objects you're currently carrying. 
-go <direction> (abbreviation for direction, like n for north, or just the direction for short): will take you in that direction to the next room/place The directions are North, East, South West, Northeast, Southeast, Southwest, Northwest, Up, and Down. There's no need to specify through what you think you're going through, like a hole, just writing the direction is enough! 
-ask <person> about <object>: If there's a named person, you can ask them about objects you may have learned about. 
-put <object> on <object>: will set the first object on top of the second one. 
-pray to <diety>: allows you to sacrifice a gift in order to receive wisdom from a diety in their temple. You can only pray to the diety of that temple.

>south
Agora
You walk into a bustling marketplace with three major vendors. Hopefully you can find some useful items here. There seem to be three pretty well established vendors here to the north, west, and south.

* * *

>go west
Agora
You walk into a bustling marketplace but quickly realize that you don't have anything to trade with! Maybe you can find something back in the Town Center.

>x knives
You're not very fond of weapons, but the knives catch your eyes because they're breathtaking. You walk a bit closer to them and you can see the reflection of the woman perfectly and colors dance across her skin. You might as well be entraced. These might even be made from gems and not just metal. You and the other priestesses have been thinking about getting a new ceremonial knife.

>x large vessels
You're intrigued by the large vessels try to see if you can find something of use, so you flag the woman over.

The woman comes up to you and points out that hidden small-ish boat behind some large vases and fishing boats. "I made this boat myself!" she says. She looks around and makes sure her husband is occupied with something else and whispers, "My husband over there doesn't like when I make things like he does, but I've always been drawn to it. I think once I sell it he won't be as irate anymore. Would you like to buy it? I'll accept 3 bundles of wheat or a dozen eggs. It would really mean a lot to me!"

* * *

>take lyre
It doesn't seem to be as heavy as a bag a large rocks, but it is and you can't lift it!

>look
Town Center
You wake up not quite being able to remember anything from before this moment. You look around you and notice dirt roads and beauitful foliage all around. The mountains near the northwest frame this beautiful landscape and you can sort of see some kind of buildings near the west.

There's a lyre laying against a wall. Calling out to you to play since its owner is nowhere to be found.

Specifically among the foliage, you spot an apple tree with delicious apples ripe for the picking!

Behind a corner you spot a hole in the ground that you can probably fit into.

* * *

>play lyre
You play a beautiful melody and even sing a bit. It was so touching that some towns folk have given you a couple pieces of gold, which will probably only get you three things at the marketplace. You might as well take the coins and head towards there!

>look
Town Center
You wake up not quite being able to remember anything from before this moment. All you remember is that you're Greek and you live on an island called Sarpedon. You look around you and notice dirt roads and beauitful foliage all around and a calmly flowing river to the north. The mountains near the northeast frame this beautiful landscape and you can sort of see some kind of buildings near the east. To the west you hear the bustling noise of what is most likely people trading.

On the ground in front of your feet you can see gold coins tossed at you from when you played the lyre.

There's a lyre laying against a wall. Calling out to you to play it since its owner is nowhere to be found.

Specifically among the foliage, you spot an apple tree with delicious apples ripe for the picking! Maybe one will fall soon.

Behind a corner you spot a hole in the ground that you can probably fit down into.

>take coins
Now the coins are in your inventory (i).

>i
You are carrying:
  a sack of coins

* * *

>go west
Agora
You walk into a bustling marketplace with three major vendors. Hopefully you can find some useful items here. There seem to be three pretty well established vendors here to the north, west, and south.

>go west
Vendor 2
You almost trip walking up to this stand because the vendor is so beautiful and you literally stopped paying attention to where you were going.  To quickly try to impress her, you take stock of what she's selling and try to find an interesting fact that you know. If only you could remember anything about plants and herbs! If only you remembered to stop walking instead of being drawn ever so closer and bumping into her cart! You also notice a small trap door leading down somewhere. next to the side of this woman's cart.
She seems to like your awkwardness so that's a plus! She says, "Hey there! You seem like just the woman I've been looking for!" While you love that she's been looking for you, you are still really confused. You are about to say something but she stops you by saying, "I know that this might seem weird, but I promise that I'm here to help! You should definitely go to the Temple of Athena. I feel like you're needed there."

The woman introduces herself as Antheia and it doesn't surprise you that her name is as beautiful as she is. You feel like you can ask her about anything and she would know the answer.

You can also see oregano, marjoram, fennel, mint, sideritis, chamomile and flowers here.

>x Antheia
You can't see any such thing.

>go east
Agora
You walk into a bustling marketplace with three major vendors. Hopefully you can find some useful items here. There seem to be three pretty well established vendors here to the north, west, and south.

>go north
Vendor 1
You walk up to a stand where a burly man and his wife show you all the neat woodworking and ceramic items they've made and have to sell. Well at least you assume the small, toned lady made some of these items. You're not actually sure. There are many beautiful wooden sculptures here that you don't think the burly man hand the patience or delicacy to make, but he treats the woman like a lowly shop hand. You wish you could make her situation better. Maybe buying something of hers would be good.

You can see plates, axes, knives, pots, vases and large vessels here.

>x large vessels
You're intrigued by the large vessels try to see if you can find something of use, so you flag the woman over.

The woman comes up to you and points out that hidden small-ish boat behind some large vases and fishing boats. "I made this boat myself!" she says. She looks around and makes sure her husband is occupied with something else and whispers, "My husband over there doesn't like when I make things like he does, but I've always been drawn to it. I think once I sell it he won't be as irate anymore. Would you like to buy it? I'll accept 3 bundles of wheat or a dozen eggs. It would really mean a lot to me!"

>look
Vendor 1
You walk up to a stand where a burly man and his wife show you all the neat woodworking and ceramic items they've made and have to sell. Well at least you assume the small, toned lady made some of these items. You're not actually sure. There are many beautiful wooden sculptures here that you don't think the burly man hand the patience or delicacy to make, but he treats the woman like a lowly shop hand. You wish you could make her situation better. Maybe buying something of hers would be good.

You can see a boat, plates, axes, knives, pots, vases and large vessels here.

>go south
Agora
You walk into a bustling marketplace with three major vendors. Hopefully you can find some useful items here. There seem to be three pretty well established vendors here to the north, west, and south.

>go west
Vendor 2
You almost trip walking up to this stand because the vendor is so beautiful and you literally stopped paying attention to where you were going.  To quickly try to impress her, you take stock of what she's selling and try to find an interesting fact that you know. If only you could remember anything about plants and herbs! If only you remembered to stop walking instead of being drawn ever so closer and bumping into her cart!

You can see oregano, marjoram, fennel, mint, sideritis, chamomile, flowers and a cinnamon here.

>ask about cinnamon
You can't see any such thing.

>ask about cinnamon
You can't see any such thing.

>go east
Agora
You walk into a bustling marketplace with three major vendors. Hopefully you can find some useful items here. There seem to be three pretty well established vendors here to the north, west, and south.

>go north
Vendor 1
You walk up to a stand where a burly man and his wife show you all the neat woodworking and ceramic items they've made and have to sell. Well at least you assume the small, toned lady made some of these items. You're not actually sure. There are many beautiful wooden sculptures here that you don't think the burly man hand the patience or delicacy to make, but he treats the woman like a lowly shop hand. You wish you could make her situation better. Maybe buying something of hers would be good.

You can see a boat, plates, axes, knives, pots, vases and large vessels here.

>ask about cinnamon
You can't see any such thing.

>ask about plates
You can't see any such thing.

>go south
Agora
You walk into a bustling marketplace with three major vendors. Hopefully you can find some useful items here. There seem to be three pretty well established vendors here to the north, west, and south.

* * *

>go west
Vendor 2
You almost trip walking up to this stand because the vendor is so beautiful and you literally stopped paying attention to where you were going.  To quickly try to impress her, you take stock of what she's selling and try to find an interesting fact that you know. If only you could remember anything about plants and herbs! If only you remembered to stop walking instead of being drawn ever so closer and bumping into her cart!

You can see oregano, marjoram, fennel, mint, sideritis, chamomile, flowers and a cinnamon here.

>ask cinnamon
You can only do that to something animate.

* * *

>Ask Antheia about dragon's blood
Here take this torch and go under ground

>go down
Under Vendor 2

>go east
Under Agora

>go east
Town Center Underground
You can see the light filtering through from the Town Center but that's about all you can see. It's super dark in here.

* * *

>ask Antheia about olives
Antheia is slient for a moment and then puts her hand on your shoulder and points you to a vendor that is southeast from her. "That vendor should have some olives for you. I know that Athena just loves olives, and I think she would love to talk to you if you had some. Sometimes the Gods speak through me," she tells you with a smile. The touch from her hand sends shivers throughout your entire body. She senses that and starts to giggle.

"Surely touch cannot be that foreign to you that you shiver in fear at the response!" she tells you with a sly smile on her face. She must know what she's doing to you.

"No no no! I just. It's not that your touch is bad or anything of that sort! In fact, I like it a lot. Maybe too much! But not in a bad way! Askgldjsalfdj, I'm just going to quit now before I ramble you into an early grave," you respond with the social grace of a dancer with no flexibility or rhythm.

"Oh? Well I implore you, please go on! It's not every day I see a beautiful girl at my store, and I want to know what you like, so that you'll come back and spend some more time with me!" she responds back. If only you could remember anything, because you can't even remember what flirting looked like or how to do it and so you don't even know how to handle yourself.

"I'm already planning on coming back! You're so sweet and you've been helping me out quite a lot!" you tell her with all the scincerity in the world.

"I'm looking forward to it gorgeous" she tells you as she went to go help another customer.

>go east
Agora
You walk into a bustling marketplace with three major vendors. Hopefully you can find some useful items here. There seem to be three pretty well established vendors here to the north, west, and south.

>go south
Vendor 3
You really want to avoid this cart because the man running it seems to really hate you, and for what!? You just got here! You can also hear him spouting some vile insults about a priestess in the Temple of Athena. You don't think he'll be a friend to you, but he has a bunch of food and clothing though and that could be really useful.

You can see olives, bundles of wheat, a dozen eggs, figs, vases of milk, grapes and lentils here.

>take olives
This man has been very disgusted with you for no reason. He sees you touching an olive and hears you ask how much it is and declares that the whole batch must be thrown out because it's been contaminated! He throws the basket of olives on the floor and spits in your direction. You don't remember if you've done anything to this man, but you take the olives on the floor any way.

Check your inventory!You have the olives now!

>i
You are carrying:
  olives
  a sack of coins

>go north
Agora
You walk into a bustling marketplace with three major vendors. Hopefully you can find some useful items here. There seem to be three pretty well established vendors here to the north, west, and south.

>go west
Vendor 2
You almost trip walking up to this stand because the vendor is so beautiful and you literally stopped paying attention to where you were going.  To quickly try to impress her, you take stock of what she's selling and try to find an interesting fact that you know. If only you could remember anything about plants and herbs! If only you remembered to stop walking instead of being drawn ever so closer and bumping into her cart! You also notice a small trap door leading down somewhere. next to the side of this woman's cart.
She seems to like your awkwardness so that's a plus! She says, "Hey there! You seem like just the woman I've been looking for!" While you love that she's been looking for you, you are still really confused. You are about to say something but she stops you by saying, "I know that this might seem weird, but I promise that I'm here to help! You should definitely go to the Temple of Athena. I feel like you're needed there."

The woman introduces herself as Antheia and it doesn't surprise you that her name is as beautiful as she is. You feel like you can ask her about anything and she would know the answer.

You can also see oregano, marjoram, fennel, mint, sideritis, chamomile and flowers here.

>ask about Medusa's house
You can't see any such thing.

>ask Antheia about Medusa's house
"All that I know about Medusa is that she is a priestess for Athena and lives in home somewhere in the mountains!" Antheia replies.

>ask Antheia about medusa's house
"All that I know about Medusa is that she is a priestess for Athena and lives in home somewhere in the mountains!" Antheia replies.

>ask Antheia about Medusa
"All that I know about Medusa is that she is a priestess for Athena and lives in home somewhere in the mountains!" Antheia replies.

>ask Antheia about knife
"You've actually already seen this item before coming to me! It's not very far either. Maybe you should go back to other vendors and examine their wares more closely," says Antheia with that cute smirk that makes you melt.

>ask Antheia about ceremonial knife
"You've actually already seen this item before coming to me! It's not very far either. Maybe you should go back to other vendors and examine their wares more closely," says Antheia with that cute smirk that makes you melt.

>help
Welcome to the Help List!

This is a list of commands that you can type in that would be useful to you in the game. If you're unsure of how to do something, or stuck at a particular point, try some of these commands and you may get some hints.

The format of this list will be  <Command>: <what the command does>. 
<object> means replace that with the actual name of the object in the command. 
<person> means replace that with the name of a person that you meet in the command. etc.
-look: will redescribe the room/place you're in and the things in it. 
-examine (x for short): will take a closer look at an object in the room/place. 
         eg. examine plates 
-play <object>: if the object is an instrument, this command allows you to play it. 
         eg. play guitar 
-take <object>: if you can take an object and carry it with you, this command will put it in your inventory so that you can keep the object on your person. You can also buy items buy using the take command. As an alternative you can use the buy command. 
         eg. take stool 
-buy <object>: this allows you to buy wares from vendors. You can also use the take command. 
         eg. buy peaches 
-drop <object>: will remove an object from your inventory and into the room/place you're in. 
         eg. drop candle 
-inventory (i for short): will show you all the objects you're currently carrying. 
-go <direction> (abbreviation for direction, like n for north, or just the direction for short): will take you in that direction to the next room/place The directions are North, East, South West, Northeast, Southeast, Southwest, Northwest, Up, and Down. There's no need to specify through what you think you're going through, like a hole, just writing the direction is enough! 
          eg. go down 
-ask <person> about <object>: If there's a named person, you can ask them about objects you may have learned about. 
          eg. ask Bob about the eggs 
-put <object> on <object>: will set the first object on top of the second one. 
         eg. put cup on the table 
-pray to <diety>: allows you to sacrifice a gift in order to receive wisdom from a diety in their temple. To pray you must put a gift on the altar first. You can only pray to the diety of that temple, and you can only pray to that diety at the altar. 
         eg. pray to Venus, or just pray 
-open <object>: will open any unlocked object that is closed. 
         eg. open box

>look
Vendor 2
You almost trip walking up to this stand because the vendor is so beautiful and you literally stopped paying attention to where you were going.  To quickly try to impress her, you take stock of what she's selling and try to find an interesting fact that you know. If only you could remember anything about plants and herbs! If only you remembered to stop walking instead of being drawn ever so closer and bumping into her cart! You also notice a small trap door leading down somewhere. next to the side of this woman's cart.
She seems to like your awkwardness so that's a plus! She says, "Hey there! You seem like just the woman I've been looking for!" While you love that she's been looking for you, you are still really confused. You are about to say something but she stops you by saying, "I know that this might seem weird, but I promise that I'm here to help! You should definitely go to the Temple of Athena. I feel like you're needed there."

The woman introduces herself as Antheia and it doesn't surprise you that her name is as beautiful as she is. You feel like you can ask her about anything and she would know the answer.

You can also see oregano, marjoram, fennel, mint, sideritis, chamomile and flowers here.

>ask Antheia about Tiger Lily
Antheia rummages through her stock and finds you a Tiger Lily that you can buy from her for a dozen eggs. She tells you, "Are you looking to pray to Athena? If so, this is a very good, simple gift. Cinnamon is another good option! Don't be afraid to aske me any other questions. I'm certain now that the Goddesses want me to help you."

>look
Vendor 2
You almost trip walking up to this stand because the vendor is so beautiful and you literally stopped paying attention to where you were going.  To quickly try to impress her, you take stock of what she's selling and try to find an interesting fact that you know. If only you could remember anything about plants and herbs! If only you remembered to stop walking instead of being drawn ever so closer and bumping into her cart! You also notice a small trap door leading down somewhere. next to the side of this woman's cart.
She seems to like your awkwardness so that's a plus! She says, "Hey there! You seem like just the woman I've been looking for!" While you love that she's been looking for you, you are still really confused. You are about to say something but she stops you by saying, "I know that this might seem weird, but I promise that I'm here to help! You should definitely go to the Temple of Athena. I feel like you're needed there."

The woman introduces herself as Antheia and it doesn't surprise you that her name is as beautiful as she is. You feel like you can ask her about anything and she would know the answer.

You can also see a tiger lily, oregano, marjoram, fennel, mint, sideritis, chamomile and flowers here.

>go east
Agora
You walk into a bustling marketplace with three major vendors. Hopefully you can find some useful items here. There seem to be three pretty well established vendors here to the north, west, and south.

>go south
Vendor 3
You really want to avoid this cart because the man running it seems to really hate you, and for what!? You just got here! You can also hear him spouting some vile insults about a priestess in the Temple of Athena. You don't think he'll be a friend to you, but he has a bunch of food and clothing though and that could be really useful.

You can see bundles of wheat, a dozen eggs, figs, vases of milk, grapes and lentils here.

>buy bundles of wheat, a dozen eggs, lentils
You can't use multiple objects with that verb.

>take bundles of wheat, a dozen eggs, lentils
bundles of wheat: You've purchased some bundles of wheat, and left some coins on the counter.
You've purchased some bundles of wheat, and left some coins on the counter.

Taken.
dozen eggs: You've purchased a dozen eggs, and left some coins on the counter.

Taken.
lentils: You've purchases some lentils, and left some coins on the counter.

Taken.

>go north
Agora
You walk into a bustling marketplace with three major vendors. Hopefully you can find some useful items here. There seem to be three pretty well established vendors here to the north, west, and south.

>go west
Vendor 2
You almost trip walking up to this stand because the vendor is so beautiful and you literally stopped paying attention to where you were going.  To quickly try to impress her, you take stock of what she's selling and try to find an interesting fact that you know. If only you could remember anything about plants and herbs! If only you remembered to stop walking instead of being drawn ever so closer and bumping into her cart! You also notice a small trap door leading down somewhere. next to the side of this woman's cart.
She seems to like your awkwardness so that's a plus! She says, "Hey there! You seem like just the woman I've been looking for!" While you love that she's been looking for you, you are still really confused. You are about to say something but she stops you by saying, "I know that this might seem weird, but I promise that I'm here to help! You should definitely go to the Temple of Athena. I feel like you're needed there."

The woman introduces herself as Antheia and it doesn't surprise you that her name is as beautiful as she is. You feel like you can ask her about anything and she would know the answer.

You can also see a tiger lily, oregano, marjoram, fennel, mint, sideritis, chamomile and flowers here.

>buy tiger lily
You now have a Tiger Lily!

>go east
Agora
You walk into a bustling marketplace with three major vendors. Hopefully you can find some useful items here. There seem to be three pretty well established vendors here to the north, west, and south.

>go east
Town Center
You're back to the beautiful courtyard dirt roads, beautiful foliage, river near the north, mountains near the northeast, some kind of buildings near the east, the bustling marketplace near the west, and the marvelous Temple of Athena to the south

There's a lyre laying against a wall. Calling out to you to play it since its owner is nowhere to be found.

Specifically among the foliage, you spot an apple tree with delicious apples ripe for the picking! Maybe one will fall soon.

Behind a corner you spot a hole in the ground that you can probably fit down into.

>go south
Temple of Athena
As soon as you step foot within the temple you hear dramatic whisperings.

"I can't believe she would do that", a priestess said.

"What did she do?", another priestess asked.

"Oh you didn't hear? Our fellow priestess Medusa broke her vow and had sex with a man in this very temple!", exclaimed the first priestess.

The second priestess gasps loudly and says,"I can't believe she would disgrace Athena like that! How vile! How disgusting!"

They never look in your direction and walk into a different room. You then take the time to look around.

Athena deserves only the best and that's exactly what this temple is. It's pristine and made with the finest marble possible. Bits of gold and other gems make the temple sparkle with magical radiance as the sun hits it just right. You can see the magnificent statue of Athena and what looks like an altar to the south.

You see a prayer book, and It's a very elegant and ornate book and maybe you can find the answers you've been searching for if you read the prayer book.

You can see a book stand here.

>read prayer book
Our Goddess Athena:

Our Goddess requires gifts to give us her devine thoughts. For us to get our gifts to Athena, we've built a special altar underneath her magnificent statue in the room south of here.

At the altar, we can place our gift first and it will be burnt after you start to pray so that the smoke will rise up to our Goddess. After she is done communicating with us, she returns our gift to us in gratitude, and it won't be a pile of ashes anymore! Your gift will not disappear so remember to take it after you have finished praying. Also, only put one item on the altar, so that Athena knows what advice to give you!

Athena has some favorite types of gifts. Each gift tends to garner a different response from our Goddess so if you'd like the full story from her, you should bring many gifts. Here's a list of gifts that we've found to favorable so far (the list may change): Olives

You're not really sure where to find those gifts mentioned yet so maybe you can ask somebody in the Agora about these gifts for help.

>go south
Statue of Athena
A very simplistic room. There's not much in it, but there doesn't need to be. The building material is beautiful in and of its self, and this accentuates the other things in the room. You also notice a staircase that leads down near the back of this room.

A towering marble statue of Athena looms above you and you wonder how something so rigid like marble can look so fluid like cloth.

There's a wide block with a dip in the center that looks slightly singed in front of the statue. This must be the altar.

It feels like the Goddess Athena herself is present

>put olives on altar
You put olives on the altar.

>pray
(to Athena)
 The olives start to burn as soon as you started to pray and the fire doesn't feel from this world because the fire is green. You can hear Athena's voice inside your head.

"You've heard about the priestess that defiled this temple. Well my child, Medusa was not at fault. The circumstances are not what you've heard...."

You feel the presence of Athena leave your head. You should probably go read the prayer book again to see if anything has changed.

>put tiger lilly on altar
I didn't understand that sentence.

>put tiger lily on altar
You already have an item on the altar. Make sure you take it off first by using the command take.

>look
Statue of Athena
A very simplistic room. There's not much in it, but there doesn't need to be. The building material is beautiful in and of its self, and this accentuates the other things in the room. You also notice a staircase that leads down near the back of this room.

A towering marble statue of Athena looms above you and you wonder how something so rigid like marble can look so fluid like cloth.

There's a wide block with a dip in the center that looks slightly singed in front of the statue. This must be the altar.

On the altar is olives.

It feels like the Goddess Athena herself is present

>take olives
You have the olives now!

>put tiger lily on altar
You put the tiger lily on the altar.

>pray
(to Athena)
 The Tiger Lily shrinks into the lime green fire. The sweet scent still hits your nose, and Athena's voice is back inside your head.

"Ah my child, thank you for such a beautiful gift. Those circumstances with Medusa, they were terrible and vile and it fills me up with rage! My daughter, my fellow God," she told you with disgust," Posiedon forced himself on my priestess Medusa. She fought the whole way but she of course was no match for him. He and Zeus had the nerve to force me to discipline her for being an unwilling part of this defiling this temple...."

In anger, Athena's presence left your head. You should probably go read the prayer book again to see if anything has changed.

>go north
Temple of Athena
They be gossiping about Medusa banging a guy still in another room. But you ignore that.

This temple is still stunning! It's pristine and made with the finest marble possible. Bits of gold and other gems make the temple sparkle with magical radiance as the sun hits it just right. You can see the magnificent statue of Athena and what looks like an altar to the south.

You see a prayer book, and It's a very elegant and ornate book and maybe you can find the answers you've been searching for if you read the prayer book.

You can see a book stand here.

>read prayer book
Our Goddess Athena:

Our Goddess requires gifts to give us her devine thoughts. For us to get our gifts to Athena, we've built a special altar underneath her magnificent statue in the room south of here.

At the altar, we can place our gift first and it will be burnt after you start to pray so that the smoke will rise up to our Goddess. After she is done communicating with us, she returns our gift to us in gratitude, and it won't be a pile of ashes anymore! Your gift will not disappear so remember to take it after you have finished praying. Also, only put one item on the altar, so that Athena knows what advice to give you!

Athena has some favorite types of gifts. Each gift tends to garner a different response from our Goddess so if you'd like the full story from her, you should bring many gifts. Here's a list of gifts that we've found to favorable so far (the list may change): Olives, a Tiger Lily

You're not really sure where to find those gifts mentioned yet so maybe you can ask somebody in the Agora about these gifts for help.

>go south
Statue of Athena
A very simplistic room. There's not much in it, but there doesn't need to be. The building material is beautiful in and of its self, and this accentuates the other things in the room. You also notice a staircase that leads down near the back of this room.

A towering marble statue of Athena looms above you and you wonder how something so rigid like marble can look so fluid like cloth.

There's a wide block with a dip in the center that looks slightly singed in front of the statue. This must be the altar.

On the altar is a tiger lily.

It feels like the Goddess Athena herself is present

>pray
(to Athena)
 The Tiger Lily shrinks into the lime green fire. The sweet scent still hits your nose, and Athena's voice is back inside your head.

"Ah my child, thank you for such a beautiful gift. Those circumstances with Medusa, they were terrible and vile and it fills me up with rage! My daughter, my fellow God," she told you with disgust," Posiedon forced himself on my priestess Medusa. She fought the whole way but she of course was no match for him. He and Zeus had the nerve to force me to discipline her for being an unwilling part of this defiling this temple...."

In anger, Athena's presence left your head. You should probably go read the prayer book again to see if anything has changed.

* * *

>go north
Temple of Athena
They be gossiping about Medusa banging a guy still in another room. But you ignore that.

This temple is still stunning! It's pristine and made with the finest marble possible. Bits of gold and other gems make the temple sparkle with magical radiance as the sun hits it just right. You can see the magnificent statue of Athena and what looks like an altar to the south.

You see a prayer book, and It's a very elegant and ornate book and maybe you can find the answers you've been searching for if you read the prayer book.

You can see a book stand here.

>read book
(the book stand)
Our Goddess Athena:

Our Goddess requires gifts to give us her devine thoughts. For us to get our gifts to Athena, we've built a special altar underneath her magnificent statue in the room south of here.

At the altar, we can place our gift first and it will be burnt after you start to pray so that the smoke will rise up to our Goddess. After she is done communicating with us, she returns our gift to us in gratitude, and it won't be a pile of ashes anymore! Your gift will not disappear so remember to take it after you have finished praying. Also, only put one item on the altar, so that Athena knows what advice to give you!

Athena has some favorite types of gifts. Each gift tends to garner a different response from our Goddess so if you'd like the full story from her, you should bring many gifts. Here's a list of gifts that we've found to favorable so far (the list may change): Olives, a Tiger Lily

You're not really sure where to find those gifts mentioned yet so maybe you can ask somebody in the Agora about these gifts for help.

* * *

>take boat
You need to get wheat first!

>go south
Agora
You walk into a bustling marketplace with three major vendors. Hopefully you can find some useful items here. There seem to be three pretty well established vendors here to the north, west, and south.

>go west
Vendor 2
You almost trip walking up to this stand because the vendor is so beautiful and you literally stopped paying attention to where you were going.  To quickly try to impress her, you take stock of what she's selling and try to find an interesting fact that you know. If only you could remember anything about plants and herbs! If only you remembered to stop walking instead of being drawn ever so closer and bumping into her cart! You also notice a small trap door leading down somewhere. next to the side of this woman's cart.

The woman introduces herself as Antheia and it doesn't surprise you that her name is as beautiful as she is. You feel like you can ask her about anything and she would know the answer.

You can also see oregano, marjoram, fennel, mint, sideritis, chamomile and flowers here.

>ask Antheia about cinnamon
Antheia rummages through her stock and finds you a vial of cinnamon that you can buy from her for some lentils. She tells you, "Are you looking to pray to Athena? If so, this is a very good, simple gift. Tiger Lillies are another good option! Don't be afraid to ask me any other questions. I feel drawn to you in a way that I don't with other people."

>look
Vendor 2
You almost trip walking up to this stand because the vendor is so beautiful and you literally stopped paying attention to where you were going.  To quickly try to impress her, you take stock of what she's selling and try to find an interesting fact that you know. If only you could remember anything about plants and herbs! If only you remembered to stop walking instead of being drawn ever so closer and bumping into her cart!

The woman introduces herself as Antheia and it doesn't surprise you that her name is as beautiful as she is.

You can also see a vial of cinnamon, oregano, marjoram, fennel, mint, sideritis, chamomile and flowers here.

>ask Antheia about cinnamon
"I've already shown you my whole stock of cinnamon," Antheia says.

* * *

>ask Antheia about cinnamon
Antheia rummages through her stock and finds you a vial of cinnamon that you can buy from her for some lentils. She tells you, "Are you looking to pray to Athena? If so, this is a very good, simple gift. Tiger Lillies are another good option! Don't be afraid to ask me any other questions. I feel drawn to you in a way that I don't with other people."

>ask Antheia about Tiger Lilly
There is no reply.

>take cinnamon
You need to get some lentils first to pay for that!

>take Tiger Lilly
You can't see any such thing.

>go east
Agora
You walk into a bustling marketplace with three major vendors. Hopefully you can find some useful items here. There seem to be three pretty well established vendors here to the north, west, and south.

>go south
Vendor 3
You really want to avoid this cart because the man running it seems to really hate you, and for what!? You just got here! He has a bunch of food and clothing though and that could be really useful.

You can see olives, bundles of wheat, a dozen eggs, figs, vases of milk, grapes and lentils here.

>take bundles of wheat, a dozen eggs, and lentils
You can't see any such thing.

>take bundles of wheat, a dozen eggs, lentils
bundles of wheat: You've purchased some bundles of wheat, and left some coins on the counter.

Taken.
dozen eggs: You've purchased a dozen eggs, and left some coins on the counter.

Taken.
lentils: You've purchases some lentils, and left some coins on the counter.

Taken.

>i
You are carrying:
  lentils
  a dozen eggs
  bundles of wheat
  a sack of coins

>go north
Agora
You walk into a bustling marketplace with three major vendors. Hopefully you can find some useful items here. There seem to be three pretty well established vendors here to the north, west, and south.

>i
You are carrying:
  lentils
  a dozen eggs
  bundles of wheat

>go north
Vendor 1
You walk up to a stand where a burly man and his wife show you all the neat woodworking and ceramic items they've made and have to sell. Well at least you assume the small, toned lady made some of these items. You're not actually sure. There are many beautiful wooden sculptures here that you don't think the burly man hand the patience or delicacy to make, but he treats the woman like a lowly shop hand. You wish you could make her situation better. Maybe buying something of hers would be good.

You can see a boat, a ceremonial knife, plates, axes, knives, pots, vases and large vessels here.

>take boat
Thank you kind woman for your wheat! May this boat be blessed by Athena herself for safe travels! Speaking of Athena, it really is a shame that one of her priestesses disgraced the temple like that! Where did she go getting such an idea! Anyways, have a good day and come back real soon!
The woman again calls after you, "Kind woman I gave you an extra gift for the pleasure of speaking with you! I noticed your interest in other wares of mine. I hope you like it!"

>go south
Agora
You walk into a bustling marketplace with three major vendors. Hopefully you can find some useful items here. There seem to be three pretty well established vendors here to the north, west, and south.

>go west
Vendor 2
You almost trip walking up to this stand because the vendor is so beautiful and you literally stopped paying attention to where you were going.  To quickly try to impress her, you take stock of what she's selling and try to find an interesting fact that you know. If only you could remember anything about plants and herbs! If only you remembered to stop walking instead of being drawn ever so closer and bumping into her cart! You also notice a small trap door leading down somewhere. next to the side of this woman's cart.

The woman introduces herself as Antheia and it doesn't surprise you that her name is as beautiful as she is. You feel like you can ask her about anything and she would know the answer.

You can also see a vial of cinnamon, oregano, marjoram, fennel, mint, sideritis, chamomile and flowers here.

>take cinnamon
You now hava vial of cinnamon!

>i
You are carrying:
  a vial of cinnamon
  a ceremonial knife
  a boat
  a dozen eggs

>ask Antheia about river
Antheia thinks to herself for a moment, and you take the time to thank the Goddesses for bringing you someone so lovely to help you figure out what's going on. "There's a woman in another stall around here that has what you need. Find her and you should be able to find it. Don't be a stranger," Antheia says slyly, and it makes your heart flutter.

>ask Antheia about documents
Antheia makes a motion to get closer and so you lean in incredibly aware of how far away you are from her lips, but you restrain yourself because you would never force yourself on a person. She whispers, "I would go back to the vendor with food and clothing, and I think you might find something else there that wasn't there before."

>go east
Agora
You walk into a bustling marketplace with three major vendors. Hopefully you can find some useful items here. There seem to be three pretty well established vendors here to the north, west, and south.

>go south
Vendor 3
You really want to avoid this cart because the man running it seems to really hate you, and for what!? You just got here! He has a bunch of food and clothing though and that could be really useful.

You now notice a piece of paper slightly stuck under a rock and it seems to be a deed for a house.

You can also see olives, figs, vases of milk and grapes here.

>go north
Agora
You walk into a bustling marketplace with three major vendors. Hopefully you can find some useful items here. There seem to be three pretty well established vendors here to the north, west, and south.

>go west
Vendor 2
You almost trip walking up to this stand because the vendor is so beautiful and you literally stopped paying attention to where you were going.  To quickly try to impress her, you take stock of what she's selling and try to find an interesting fact that you know. If only you could remember anything about plants and herbs! If only you remembered to stop walking instead of being drawn ever so closer and bumping into her cart! You also notice a small trap door leading down somewhere. next to the side of this woman's cart.

The woman introduces herself as Antheia and it doesn't surprise you that her name is as beautiful as she is. You feel like you can ask her about anything and she would know the answer.

You can also see oregano, marjoram, fennel, mint, sideritis, chamomile and flowers here.

>go down
Darkness
It is pitch dark, and you can't see a thing.

>go up
Vendor 2
You almost trip walking up to this stand because the vendor is so beautiful and you literally stopped paying attention to where you were going.  To quickly try to impress her, you take stock of what she's selling and try to find an interesting fact that you know. If only you could remember anything about plants and herbs! If only you remembered to stop walking instead of being drawn ever so closer and bumping into her cart! You also notice a small trap door leading down somewhere. next to the side of this woman's cart.

The woman introduces herself as Antheia and it doesn't surprise you that her name is as beautiful as she is. You feel like you can ask her about anything and she would know the answer.

You can also see oregano, marjoram, fennel, mint, sideritis, chamomile and flowers here.

>go east
Agora
You walk into a bustling marketplace with three major vendors. Hopefully you can find some useful items here. There seem to be three pretty well established vendors here to the north, west, and south.

>go eat
You can't see any such thing.

>go east
Town Center
You're back to the beautiful courtyard dirt roads, beautiful foliage, river near the north, mountains near the northeast, some kind of buildings near the east, the bustling marketplace near the west, and the marvelous Temple of Athena to the south

There's a lyre laying against a wall. Calling out to you to play it since its owner is nowhere to be found.

Specifically among the foliage, you spot an apple tree with delicious apples ripe for the picking! Maybe one will fall soon.

Behind a corner you spot a hole in the ground that you can probably fit down into.

>go south
Temple of Athena
As soon as you step foot within the temple you hear dramatic whisperings.

"I can't believe she would do that", a priestess said.

"What did she do?", another priestess asked.

"Oh you didn't hear? Our fellow priestess Medusa broke her vow and had sex with a man in this very temple!", exclaimed the first priestess.

The second priestess gasps loudly and says,"I can't believe she would disgrace Athena like that! How vile! How disgusting!"

They never look in your direction and walk into a different room. You then take the time to look around.

Athena deserves only the best and that's exactly what this temple is. It's pristine and made with the finest marble possible. Bits of gold and other gems make the temple sparkle with magical radiance as the sun hits it just right.

You see a prayer book, and It's a very elegant and ornate book and maybe you can find the answers you've been searching for if you read the prayer book.

You can see a book stand here.

>read book
(the book stand)
Our Goddess Athena:

Our Goddess requires gifts to give us her devine thoughts. For us to get our gifts to Athena, we've built a special altar underneath her magnificent statue in the room south of here. where we can place our gift and it will be burnt after you start to pray so that the smoke will rise up to our Goddess. After she is done communicating with us, she returns our gift to us in gratitude, and it won't be a pile of ashes anymore!

We've learned that some of Athena's favorite gifts are Olives, Tiger Lillies, Cinnamon, Dragonis Blood, Onyx, Star Sapphire, and Ivory. Each gift garners a different response from Athena though so it would be a great idea to get multiple gifts for a more complete answer about something.

You're not really sure where to find those gifts mentioned yet so maybe you can ask somebody in the Agora about  these gifts for help.

>read prayer book
Our Goddess Athena:

Our Goddess requires gifts to give us her devine thoughts. For us to get our gifts to Athena, we've built a special altar underneath her magnificent statue in the room south of here. where we can place our gift and it will be burnt after you start to pray so that the smoke will rise up to our Goddess. After she is done communicating with us, she returns our gift to us in gratitude, and it won't be a pile of ashes anymore!

We've learned that some of Athena's favorite gifts are Olives, Tiger Lillies, Cinnamon, Dragonis Blood, Onyx, Star Sapphire, and Ivory. Each gift garners a different response from Athena though so it would be a great idea to get multiple gifts for a more complete answer about something.

You're not really sure where to find those gifts mentioned yet so maybe you can ask somebody in the Agora about  these gifts for help.

>go south
Statue of Athena
A very simplistic room. There's not much in it, but there doesn't need to be. The building material is beautiful in and of its self, and this accentuates the other things in the room. You also notice a staircase that leads down near the back of this room.

A towering marble statue of Athena looms above you and you wonder how something so rigid like marble can look so fluid like cloth.

There's a wide block with a dip in the center that looks slightly singed in front of the statue. This must be the altar.

It feels like the Goddess Athena herself is present

>i
You are carrying:
  a vial of cinnamon
  a ceremonial knife
  a boat
  a dozen eggs

>put cinnamon on altar
You put the vial of cinnamon on the altar.

>look
Statue of Athena
A very simplistic room. There's not much in it, but there doesn't need to be. The building material is beautiful in and of its self, and this accentuates the other things in the room. You also notice a staircase that leads down near the back of this room.

A towering marble statue of Athena looms above you and you wonder how something so rigid like marble can look so fluid like cloth.

There's a wide block with a dip in the center that looks slightly singed in front of the statue. This must be the altar.

On the altar is a vial of cinnamon.

It feels like the Goddess Athena herself is present

>take vial
You now hava vial of cinnamon!

>pray to statue
You can only do that to something animate.

>put cinnamon on altar
You put the vial of cinnamon on the altar.

>pray to statue
You can only do that to something animate.

>pray to Athena
The sweet scent of cinnamon wafts up as the ethereal fire dances on top of it. Athena's voice in your head doesn't even feel out of place anymore as if your head was where she belongs.

"I can feel your curiosity about my punishment for Medusa. She was the daughter of the sea Gods Phoroys and Ceto. Her sisters are Gorgons but she mysteriously was born a human. As a "punishment" I turned her into what her sisters are and added snakes for hair and a gaze that turns men to stone. I wanted her to never again be helpless like that....."

Your emotions are starting to mirror Athena's and as she slips away again you can't help but feel contempt for the Gods and a sense of sorrow for Medusa. You should probably go read the prayer book again to see if anything has changed.

>go north
Temple of Athena
They be gossiping about Medusa banging a guy still in another room. But you ignore that.

This temple is still stunning! It's pristine and made with the finest marble possible. Bits of gold and other gems make the temple sparkle with magical radiance as the sun hits it just right.

You see a prayer book, and It's a very elegant and ornate book and maybe you can find the answers you've been searching for if you read the prayer book.

You can see a book stand here.

>go north
Town Center
You're back to the beautiful courtyard dirt roads, beautiful foliage, river near the north, mountains near the northeast, some kind of buildings near the east, the bustling marketplace near the west, and the marvelous Temple of Athena to the south. It seems like something is different since the last time you were here.

One of the beautiful ripe apples fell down! Now you can take it.

There's a lyre laying against a wall. Calling out to you to play it since its owner is nowhere to be found.

Specifically among the foliage, you spot an apple tree with delicious apples ripe for the picking! Maybe one will fall soon.

Behind a corner you spot a hole in the ground that you can probably fit down into.

>look
Town Center
You're back to the beautiful courtyard dirt roads, beautiful foliage, river near the north, mountains near the northeast, some kind of buildings near the east, the bustling marketplace near the west, and the marvelous Temple of Athena to the south. It seems like something is different since the last time you were here.

One of the beautiful ripe apples fell down! Now you can take it.

There's a lyre laying against a wall. Calling out to you to play it since its owner is nowhere to be found.

Specifically among the foliage, you spot an apple tree with delicious apples ripe for the picking! Maybe one will fall soon.

Behind a corner you spot a hole in the ground that you can probably fit down into.

>take fallen apple
You now have an apple in your inventory (i).

>go south
Temple of Athena
They be gossiping about Medusa banging a guy still in another room. But you ignore that.

This temple is still stunning! It's pristine and made with the finest marble possible. Bits of gold and other gems make the temple sparkle with magical radiance as the sun hits it just right.

You see a prayer book, and It's a very elegant and ornate book and maybe you can find the answers you've been searching for if you read the prayer book.

You can see a book stand here.

>go north
Town Center
You're back to the beautiful courtyard dirt roads, beautiful foliage, river near the north, mountains near the northeast, some kind of buildings near the east, the bustling marketplace near the west, and the marvelous Temple of Athena to the south

There's a lyre laying against a wall. Calling out to you to play it since its owner is nowhere to be found.

Specifically among the foliage, you spot an apple tree with delicious apples ripe for the picking! Maybe one will fall soon.

Behind a corner you spot a hole in the ground that you can probably fit down into.

>look
Town Center
You're back to the beautiful courtyard dirt roads, beautiful foliage, river near the north, mountains near the northeast, some kind of buildings near the east, the bustling marketplace near the west, and the marvelous Temple of Athena to the south

There's a lyre laying against a wall. Calling out to you to play it since its owner is nowhere to be found.

Specifically among the foliage, you spot an apple tree with delicious apples ripe for the picking! Maybe one will fall soon.

Behind a corner you spot a hole in the ground that you can probably fit down into.

>go south
Temple of Athena
They be gossiping about Medusa banging a guy still in another room. But you ignore that.

This temple is still stunning! It's pristine and made with the finest marble possible. Bits of gold and other gems make the temple sparkle with magical radiance as the sun hits it just right.

You see a prayer book, and It's a very elegant and ornate book and maybe you can find the answers you've been searching for if you read the prayer book.

You can see a book stand here.

>go north
Town Center
You're back to the beautiful courtyard dirt roads, beautiful foliage, river near the north, mountains near the northeast, some kind of buildings near the east, the bustling marketplace near the west, and the marvelous Temple of Athena to the south. It seems like something is different since the last time you were here.

There's a lyre laying against a wall. Calling out to you to play it since its owner is nowhere to be found.

Specifically among the foliage, you spot an apple tree with delicious apples ripe for the picking! Maybe one will fall soon.

Behind a corner you spot a hole in the ground that you can probably fit down into.

You can also see a fallen apple here.

>look
Town Center
You're back to the beautiful courtyard dirt roads, beautiful foliage, river near the north, mountains near the northeast, some kind of buildings near the east, the bustling marketplace near the west, and the marvelous Temple of Athena to the south. It seems like something is different since the last time you were here.

There's a lyre laying against a wall. Calling out to you to play it since its owner is nowhere to be found.

Specifically among the foliage, you spot an apple tree with delicious apples ripe for the picking! Maybe one will fall soon.

Behind a corner you spot a hole in the ground that you can probably fit down into.

You can also see a fallen apple here.

>take fallen apple
You now have an apple in your inventory (i).

>inventory
You are carrying:
  a fallen apple: 2
  a ceremonial knife
  a boat
  a dozen eggs

>go south
Temple of Athena
They be gossiping about Medusa banging a guy still in another room. But you ignore that.

This temple is still stunning! It's pristine and made with the finest marble possible. Bits of gold and other gems make the temple sparkle with magical radiance as the sun hits it just right.

You see a prayer book, and It's a very elegant and ornate book and maybe you can find the answers you've been searching for if you read the prayer book.

You can see a book stand here.

* * *

>take fallen apple
You now have an apple in your inventory (i).

* * *

>go south
Temple of Athena
They be gossiping about Medusa banging a guy still in another room. But you ignore that.

This temple is still stunning! It's pristine and made with the finest marble possible. Bits of gold and other gems make the temple sparkle with magical radiance as the sun hits it just right.

You see a prayer book, and It's a very elegant and ornate book and maybe you can find the answers you've been searching for if you read the prayer book.

You can see a book stand here.

>go noth
You can't see any such thing.

>north
Town Center
You're back to the beautiful courtyard dirt roads, beautiful foliage, river near the north, mountains near the northeast, some kind of buildings near the east, the bustling marketplace near the west, and the marvelous Temple of Athena to the south

There's a lyre laying against a wall. Calling out to you to play it since its owner is nowhere to be found.

Specifically among the foliage, you spot an apple tree with delicious apples ripe for the picking! Maybe one will fall soon.

Behind a corner you spot a hole in the ground that you can probably fit down into.

>south
Temple of Athena
They be gossiping about Medusa banging a guy still in another room. But you ignore that.

This temple is still stunning! It's pristine and made with the finest marble possible. Bits of gold and other gems make the temple sparkle with magical radiance as the sun hits it just right.

You see a prayer book, and It's a very elegant and ornate book and maybe you can find the answers you've been searching for if you read the prayer book.

You can see a book stand here.

>north
Town Center
You're back to the beautiful courtyard dirt roads, beautiful foliage, river near the north, mountains near the northeast, some kind of buildings near the east, the bustling marketplace near the west, and the marvelous Temple of Athena to the south. It seems like something is different since the last time you were here.

There's a lyre laying against a wall. Calling out to you to play it since its owner is nowhere to be found.

Specifically among the foliage, you spot an apple tree with delicious apples ripe for the picking! Maybe one will fall soon.

Behind a corner you spot a hole in the ground that you can probably fit down into.

You can also see a fallen apple here.

>take fallen apple
You now have an apple in your inventory (i).

>west
Agora
You walk into a bustling marketplace with three major vendors. Hopefully you can find some useful items here. There seem to be three pretty well established vendors here to the north, west, and south.

>north
Vendor 1
You walk up to a stand where a burly man and his wife show you all the neat woodworking and ceramic items they've made and have to sell. Well at least you assume the small, toned lady made some of these items. You're not actually sure. There are many beautiful wooden sculptures here that you don't think the burly man hand the patience or delicacy to make, but he treats the woman like a lowly shop hand. You wish you could make her situation better. Maybe buying something of hers would be good.

You can see plates, axes, knives, pots, vases and large vessels here.

* * *

>inventory
You are carrying:
  a fallen apple: 4
  a ceremonial knife
  a boat
  a dozen eggs

>go south
Agora
You walk into a bustling marketplace with three major vendors. Hopefully you can find some useful items here. There seem to be three pretty well established vendors here to the north, west, and south.

* * *

>take tiger lilly
You can't see any such thing.

>i
You are carrying:
  a fallen apple: 4
  a ceremonial knife
  a boat
  a dozen eggs

>go east
Agora
You walk into a bustling marketplace with three major vendors. Hopefully you can find some useful items here. There seem to be three pretty well established vendors here to the north, west, and south.

* * *

>go east
Town Center
You're back to the beautiful courtyard dirt roads, beautiful foliage, river near the north, mountains near the northeast, some kind of buildings near the east, the bustling marketplace near the west, and the marvelous Temple of Athena to the south

There's a lyre laying against a wall. Calling out to you to play it since its owner is nowhere to be found.

Specifically among the foliage, you spot an apple tree with delicious apples ripe for the picking! Maybe one will fall soon.

Behind a corner you spot a hole in the ground that you can probably fit down into.

>go down
Darkness
It is pitch dark, and you can't see a thing.

>go up
Town Center
You're back to the beautiful courtyard dirt roads, beautiful foliage, river near the north, mountains near the northeast, some kind of buildings near the east, the bustling marketplace near the west, and the marvelous Temple of Athena to the south. It seems like something is different since the last time you were here.

There's a lyre laying against a wall. Calling out to you to play it since its owner is nowhere to be found.

Specifically among the foliage, you spot an apple tree with delicious apples ripe for the picking! Maybe one will fall soon.

Behind a corner you spot a hole in the ground that you can probably fit down into.

You can also see a fallen apple here.

>go west
Agora
You walk into a bustling marketplace with three major vendors. Hopefully you can find some useful items here. There seem to be three pretty well established vendors here to the north, west, and south.

>go west
Vendor 2
You almost trip walking up to this stand because the vendor is so beautiful and you literally stopped paying attention to where you were going.  To quickly try to impress her, you take stock of what she's selling and try to find an interesting fact that you know. If only you could remember anything about plants and herbs! If only you remembered to stop walking instead of being drawn ever so closer and bumping into her cart! You also notice a small trap door leading down somewhere. next to the side of this woman's cart.

The woman introduces herself as Antheia and it doesn't surprise you that her name is as beautiful as she is. You feel like you can ask her about anything and she would know the answer.

You can also see oregano, marjoram, fennel, mint, sideritis, chamomile and flowers here.

>ask Antheia about dragon's blood
"Hmmmm. Dragon's blood is awfully peculiar for just anybody to have. You must be really wanting to talk to Athena if you need to find something that can't be readily found in the Agora! She's so lucky to have such a devoted follower like you!" Antheia says admiringly.

"Oh honestly the pleasure is mine. I'm learning so much and she truly is devine. I'm just glad that she wants to communicate with me, and I would never have been able to without your help! You've truly been amazing! How do you know so much about giving gifts to Athena?" you respond, eager to have a conversation with the sales woman.

"Let's just say that I know our Goddess Athena quite well and that I owe her. Now, for your Dragon's blood, it will most likely be found somewhere underneath the city where liquid rushes through just like blood might. Take this torch so that you can find your way down there!" Antheia hands you a lit torch and mysteriously dips away to help someone else. Maybe one day you'll figure her out.

>go down
Under Vendor 2
You see the trapdoor above you (that you can go up through) and you instantly know you're under Antheia's cart! It seems like she might use this area to store some of her wares, but there isn't much decoration in this room, just stone and dirt.

You can see Mounds of Oregon, Mounds of Margoram, Mounds of fennel and Various mounds of other herbs here.

>go east
Under Agora
By all the rumbling you hear above you, you deduce that you're under the Agora right now. There are magnificent things down here now that you have a light to see with! There are many many expertly crafted things in here and you wonder why they're under the Agora instead of displayed at the Agora itself!

You can see a metal chest, a shelf and a table 1 here.

>east
Town Center Underground
You can see the light filtering through from the Town Center but that's about all you can see. Even with the torch it's pretty dim in here and there doesn't seem to be anything down here. Exploration might help you find useful things though.

>north
Under Upper River
The waterfall cascading from above is such beautiful sight, but it does make this entire area damp. There isn't really anything in this area, but as you step closer to the underground river and waterfall you notice that part of the stream is blood red and leads into the lower part of the river.

There are large amounts of moss covering the walls and floor.

>southeast
Under Lower River
As the light dances around you and you see the reflection of the flame in the water, you notice that the river just ends. You can't see where it goes. It just hits a wall and ends. You get closer to the edge of the river and you the small inner stream of blood being sucked into this glass box. There's a passage way to the northeast

The glass box shimmers under water like it's calling to you.

There are large amounts of moss covering the walls and floor.

>go northwest
Under Upper River
The waterfall cascading from above is such beautiful sight, but it does make this entire area damp. There isn't really anything in this area, but as you step closer to the underground river and waterfall you notice that part of the stream is blood red and leads into the lower part of the river.

There are large amounts of moss covering the walls and floor.

>go south
Town Center Underground
You can see the light filtering through from the Town Center but that's about all you can see. Even with the torch it's pretty dim in here and there doesn't seem to be anything down here. Exploration might help you find useful things though.

>west
Under Agora
By all the rumbling you hear above you, you deduce that you're under the Agora right now. There are magnificent things down here now that you have a light to see with! There are many many expertly crafted things in here and you wonder why they're under the Agora instead of displayed at the Agora itself!

You can see a metal chest, a shelf and a table 1 here.

>west
Under Vendor 2
You see the trapdoor above you (that you can go up through) and you instantly know you're under Antheia's cart! It seems like she might use this area to store some of her wares, but there isn't much decoration in this room, just stone and dirt.

You can see Mounds of Oregon, Mounds of Margoram, Mounds of fennel and Various mounds of other herbs here.

>up
Vendor 2
You almost trip walking up to this stand because the vendor is so beautiful and you literally stopped paying attention to where you were going.  To quickly try to impress her, you take stock of what she's selling and try to find an interesting fact that you know. If only you could remember anything about plants and herbs! If only you remembered to stop walking instead of being drawn ever so closer and bumping into her cart! You also notice a small trap door leading down somewhere. next to the side of this woman's cart.

The woman introduces herself as Antheia and it doesn't surprise you that her name is as beautiful as she is. You feel like you can ask her about anything and she would know the answer.

You can also see oregano, marjoram, fennel, mint, sideritis, chamomile and flowers here.

>ask Antheia about dragon's blood
"Hmmmm. Dragon's blood is awfully peculiar for just anybody to have. You must be really wanting to talk to Athena if you need to find something that can't be readily found in the Agora! She's so lucky to have such a devoted follower like you!" Antheia says admiringly.

"Oh honestly the pleasure is mine. I'm learning so much and she truly is devine. I'm just glad that she wants to communicate with me, and I would never have been able to without your help! You've truly been amazing! How do you know so much about giving gifts to Athena?" you respond, eager to have a conversation with the sales woman.

"Let's just say that I know our Goddess Athena quite well and that I owe her. Now, for your Dragon's blood, it will most likely be found somewhere underneath the city where liquid rushes through just like blood might. Take this torch so that you can find your way down there!" Antheia hands you a lit torch and mysteriously dips away to help someone else. Maybe one day you'll figure her out.

>ask Antheia about onxy
There is no reply.

>ask Antheia about onyx
"This must be a serious conversation you're having with the marvelous Athena if you're trying to find all these gifts in one day!" Antheia says lightheartedly. She sees the somber tone in your face and realizes that this indeed must be of the utmost importance.

She wraps an arm around you, "The onyx will also be under our very feet. It is underneath the tallest point of our city. Go make haste. You shouldn't waste any time! Go talk to Athena"

Somehow Antheia knows exactly what you need and  you are extremely grateful to her.

>ask Antheia about bronze shields
"I'm glad you're back because I just had a vision. I saw shields, I saw bronze shields being dropped from the sky. It was so quick, but I know what I saw! I think Athena wants you to get to those shields." Antheia explains to you in a hurried frenzy.

"That's great! Perfect even! Athena does want me to get those shields! Did you see where they landed?" you ask her.

"Yes I think at least vaguely! I saw one near the top of a river, another one landed in a cluster of buildings, and the last one shot into a cave and seemed to be surrounded by other gold items," she informs you, "Go quickly my brave love. My vision should some man coming for the shields!"

You pull her close and kiss her. She's helped you so much and deserves all the gratitude you can muster, and she's fiercely kissing you back so you can guess that the attraction is two sided. It makes it harder for you to leave, but you both know that you have to.

>ask Antheia about shields
"I'm glad you're back because I just had a vision. I saw shields, I saw bronze shields being dropped from the sky. It was so quick, but I know what I saw! I think Athena wants you to get to those shields." Antheia explains to you in a hurried frenzy.

"That's great! Perfect even! Athena does want me to get those shields! Did you see where they landed?" you ask her.

"Yes I think at least vaguely! I saw one near the top of a river, another one landed in a cluster of buildings, and the last one shot into a cave and seemed to be surrounded by other gold items," she informs you, "Go quickly my brave love. My vision should some man coming for the shields!"

You pull her close and kiss her. She's helped you so much and deserves all the gratitude you can muster, and she's fiercely kissing you back so you can guess that the attraction is two sided. It makes it harder for you to leave, but you both know that you have to.

>ask Antheia about bronze
"I'm glad you're back because I just had a vision. I saw shields, I saw bronze shields being dropped from the sky. It was so quick, but I know what I saw! I think Athena wants you to get to those shields." Antheia explains to you in a hurried frenzy.

"That's great! Perfect even! Athena does want me to get those shields! Did you see where they landed?" you ask her.

"Yes I think at least vaguely! I saw one near the top of a river, another one landed in a cluster of buildings, and the last one shot into a cave and seemed to be surrounded by other gold items," she informs you, "Go quickly my brave love. My vision should some man coming for the shields!"

You pull her close and kiss her. She's helped you so much and deserves all the gratitude you can muster, and she's fiercely kissing you back so you can guess that the attraction is two sided. It makes it harder for you to leave, but you both know that you have to.

>ask about buildings
You can't see any such thing.

>ask about documents
You can't see any such thing.

>ask about houses
You can't see any such thing.

>ask about document
You can't see any such thing.

>ask Antheia about documents
Antheia makes a motion to get closer and so you lean in incredibly aware of how far away you are from her lips, but you restrain yourself because you would never force yourself on a person. She whispers, "I would go back to the vendor with food and clothing, and I think you might find something else there that wasn't there before."

>ask Antheia about buildings
Antheia makes a motion to get closer and so you lean in incredibly aware of how far away you are from her lips, but you restrain yourself because you would never force yourself on a person. She whispers, "I would go back to the vendor with food and clothing, and I think you might find something else there that wasn't there before."

>ask Antheia about houses
Antheia makes a motion to get closer and so you lean in incredibly aware of how far away you are from her lips, but you restrain yourself because you would never force yourself on a person. She whispers, "I would go back to the vendor with food and clothing, and I think you might find something else there that wasn't there before."

>ask Antheia about shields
"I'm glad you're back because I just had a vision. I saw shields, I saw bronze shields being dropped from the sky. It was so quick, but I know what I saw! I think Athena wants you to get to those shields." Antheia explains to you in a hurried frenzy.

"That's great! Perfect even! Athena does want me to get those shields! Did you see where they landed?" you ask her.

"Yes I think at least vaguely! I saw one near the top of a river, another one landed in a cluster of buildings, and the last one shot into a cave and seemed to be surrounded by other gold items," she informs you, "Go quickly my brave love. My vision should some man coming for the shields!"

You pull her close and kiss her. She's helped you so much and deserves all the gratitude you can muster, and she's fiercely kissing you back so you can guess that the attraction is two sided. It makes it harder for you to leave, but you both know that you have to.

>go east
Agora
You walk into a bustling marketplace with three major vendors. Hopefully you can find some useful items here. There seem to be three pretty well established vendors here to the north, west, and south.

* * *

>go east
Town Center
You're back to the beautiful courtyard dirt roads, beautiful foliage, river near the north, mountains near the northeast, some kind of buildings near the east, the bustling marketplace near the west, and the marvelous Temple of Athena to the south

There's a lyre laying against a wall. Calling out to you to play it since its owner is nowhere to be found.

Specifically among the foliage, you spot an apple tree with delicious apples ripe for the picking! Maybe one will fall soon.

Behind a corner you spot a hole in the ground that you can probably fit down into.

>go north
Upper River
 Ah the river, granter of life! So serene and peacefull. You don't see many other people around and you feel a lot safer for some reason. You look around and take stock of what you can see. You notice a slight glimmer near the bushes. 

You can see Bushes, Boulders and Trees here.

>examine bushes
As you get closer to the clump of bushes near the river, you see the source of the slight glimmer! It is in fact a bronze shield lodged into the branches of these bushes.You would be able to take it from the bushes if you tried, since it doesn't seem to be stuck.

>look
Upper River
 Ah the river, granter of life! So serene and peacefull. You don't see many other people around and you feel a lot safer for some reason. You look around and take stock of what you can see. You notice a slight glimmer near the bushes. 

You can see a bronze shield 1, Bushes, Boulders and Trees here.

* * *

>help
Welcome to the Help List!

This is a list of commands that you can type in that would be useful to you in the game. If you're unsure of how to do something, or stuck at a particular point, try some of these commands and you may get some hints.

The format of this list will be  <Command>: <what the command does>. 
<object> means replace that with the actual name of the object in the command. 
<person> means replace that with the name of a person that you meet in the command. etc.

-look: will redescribe the room/place you're in and the things in it. 
-examine (x for short): will take a closer look at an object in the room/place. 
-play <object>: if the object is an instrument, this command allows you to play it. 
-take <object>: if you can take an object and carry it with you, this command will put it in your inventory so that you can keep the object on your person. You can also buy items buy using the take command. As an alternative you can use the buy command. 
-buy <object>: this allows you to buy wares from vendors. You can also use the take command. 
-drop <object>: will remove an object from your inventory and into the room/place you're in. 
-inventory (i for short): will show you all the objects you're currently carrying. 
-go <direction> (abbreviation for direction, like n for north, or just the direction for short): will take you in that direction to the next room/place The directions are North, East, South West, Northeast, Southeast, Southwest, Northwest, Up, and Down. There's no need to specify through what you think you're going through, like a hole, just writing the direction is enough! 
-ask <person> about <object>: If there's a named person, you can ask them about objects you may have learned about. 
-put <object> on <object>: will set the first object on top of the second one. 
-pray to <diety>: allows you to sacrifice a gift in order to receive wisdom from a diety in their temple. You can only pray to the diety of that temple. 
-open <object>: will open any unlocked object that is closed.

>go s
Town Center
You're back to the beautiful courtyard dirt roads, beautiful foliage, river near the north, mountains near the northeast, some kind of buildings near the east, the bustling marketplace near the west, and the marvelous Temple of Athena to the south. It seems like something is different since the last time you were here.

There's a lyre laying against a wall. Calling out to you to play it since its owner is nowhere to be found.

Specifically among the foliage, you spot an apple tree with delicious apples ripe for the picking! Maybe one will fall soon.

Behind a corner you spot a hole in the ground that you can probably fit down into.

You can also see a fallen apple here.

>s
Temple of Athena
They be gossiping about Medusa banging a guy still in another room. But you ignore that.

This temple is still stunning! It's pristine and made with the finest marble possible. Bits of gold and other gems make the temple sparkle with magical radiance as the sun hits it just right.

You see a prayer book, and It's a very elegant and ornate book and maybe you can find the answers you've been searching for if you read the prayer book.

You can see a book stand here.

>s
Statue of Athena
A very simplistic room. There's not much in it, but there doesn't need to be. The building material is beautiful in and of its self, and this accentuates the other things in the room. You also notice a staircase that leads down near the back of this room.

A towering marble statue of Athena looms above you and you wonder how something so rigid like marble can look so fluid like cloth.

There's a wide block with a dip in the center that looks slightly singed in front of the statue. This must be the altar.

On the altar is a vial of cinnamon.

It feels like the Goddess Athena herself is present

>pray
(to Athena)
The sweet scent of cinnamon wafts up as the ethereal fire dances on top of it. Athena's voice in your head doesn't even feel out of place anymore as if your head was where she belongs.

"I can feel your curiosity about my punishment for Medusa. She was the daughter of the sea Gods Phoroys and Ceto. Her sisters are Gorgons but she mysteriously was born a human. As a "punishment" I turned her into what her sisters are and added snakes for hair and a gaze that turns men to stone. I wanted her to never again be helpless like that....."

Your emotions are starting to mirror Athena's and as she slips away again you can't help but feel contempt for the Gods and a sense of sorrow for Medusa. You should probably go read the prayer book again to see if anything has changed.

>n
Temple of Athena
They be gossiping about Medusa banging a guy still in another room. But you ignore that.

This temple is still stunning! It's pristine and made with the finest marble possible. Bits of gold and other gems make the temple sparkle with magical radiance as the sun hits it just right.

You see a prayer book, and It's a very elegant and ornate book and maybe you can find the answers you've been searching for if you read the prayer book.

You can see a book stand here.

>n
Town Center
You're back to the beautiful courtyard dirt roads, beautiful foliage, river near the north, mountains near the northeast, some kind of buildings near the east, the bustling marketplace near the west, and the marvelous Temple of Athena to the south

There's a lyre laying against a wall. Calling out to you to play it since its owner is nowhere to be found.

Specifically among the foliage, you spot an apple tree with delicious apples ripe for the picking! Maybe one will fall soon.

Behind a corner you spot a hole in the ground that you can probably fit down into.

>down
Town Center Underground
You can see the light filtering through from the Town Center but that's about all you can see. Even with the torch it's pretty dim in here and there doesn't seem to be anything down here. Exploration might help you find useful things though.

>up
Town Center
You're back to the beautiful courtyard dirt roads, beautiful foliage, river near the north, mountains near the northeast, some kind of buildings near the east, the bustling marketplace near the west, and the marvelous Temple of Athena to the south. It seems like something is different since the last time you were here.

There's a lyre laying against a wall. Calling out to you to play it since its owner is nowhere to be found.

Specifically among the foliage, you spot an apple tree with delicious apples ripe for the picking! Maybe one will fall soon.

Behind a corner you spot a hole in the ground that you can probably fit down into.

You can also see a fallen apple here.

>s
Temple of Athena
They be gossiping about Medusa banging a guy still in another room. But you ignore that.

This temple is still stunning! It's pristine and made with the finest marble possible. Bits of gold and other gems make the temple sparkle with magical radiance as the sun hits it just right.

You see a prayer book, and It's a very elegant and ornate book and maybe you can find the answers you've been searching for if you read the prayer book.

You can see a book stand here.

>take book stand
That's fixed in place.

I beg your pardon?

I beg your pardon?

>n
Town Center
You're back to the beautiful courtyard dirt roads, beautiful foliage, river near the north, mountains near the northeast, some kind of buildings near the east, the bustling marketplace near the west, and the marvelous Temple of Athena to the south

There's a lyre laying against a wall. Calling out to you to play it since its owner is nowhere to be found.

Specifically among the foliage, you spot an apple tree with delicious apples ripe for the picking! Maybe one will fall soon.

Behind a corner you spot a hole in the ground that you can probably fit down into.

>n
Upper River
 Ah the river, granter of life! So serene and peacefull. You don't see many other people around and you feel a lot safer for some reason. You look around and take stock of what you can see. 

You can see Bushes, Boulders and Trees here.

>s
Town Center
You're back to the beautiful courtyard dirt roads, beautiful foliage, river near the north, mountains near the northeast, some kind of buildings near the east, the bustling marketplace near the west, and the marvelous Temple of Athena to the south. It seems like something is different since the last time you were here.

There's a lyre laying against a wall. Calling out to you to play it since its owner is nowhere to be found.

Specifically among the foliage, you spot an apple tree with delicious apples ripe for the picking! Maybe one will fall soon.

Behind a corner you spot a hole in the ground that you can probably fit down into.

You can also see a fallen apple here.

>down
Town Center Underground
You can see the light filtering through from the Town Center but that's about all you can see. Even with the torch it's pretty dim in here and there doesn't seem to be anything down here. Exploration might help you find useful things though.

>n
Under Upper River
The waterfall cascading from above is such beautiful sight, but it does make this entire area damp. There isn't really anything in this area, but as you step closer to the underground river and waterfall you notice that part of the stream is blood red and leads into the lower part of the river.

There are large amounts of moss covering the walls and floor.

>s
Town Center Underground
You can see the light filtering through from the Town Center but that's about all you can see. Even with the torch it's pretty dim in here and there doesn't seem to be anything down here. Exploration might help you find useful things though.

>w
Under Agora
By all the rumbling you hear above you, you deduce that you're under the Agora right now. There are magnificent things down here now that you have a light to see with! There are many many expertly crafted things in here and you wonder why they're under the Agora instead of displayed at the Agora itself!

You can see a metal chest, a shelf and a table 1 here.

>w
Under Vendor 2
You see the trapdoor above you (that you can go up through) and you instantly know you're under Antheia's cart! It seems like she might use this area to store some of her wares, but there isn't much decoration in this room, just stone and dirt.

You can see Mounds of Oregon, Mounds of Margoram, Mounds of fennel and Various mounds of other herbs here.

>e
Under Agora
By all the rumbling you hear above you, you deduce that you're under the Agora right now. There are magnificent things down here now that you have a light to see with! There are many many expertly crafted things in here and you wonder why they're under the Agora instead of displayed at the Agora itself!

You can see a metal chest, a shelf and a table 1 here.

>e
Town Center Underground
You can see the light filtering through from the Town Center but that's about all you can see. Even with the torch it's pretty dim in here and there doesn't seem to be anything down here. Exploration might help you find useful things though.

>n
Under Upper River
The waterfall cascading from above is such beautiful sight, but it does make this entire area damp. There isn't really anything in this area, but as you step closer to the underground river and waterfall you notice that part of the stream is blood red and leads into the lower part of the river.

There are large amounts of moss covering the walls and floor.

>se
Under Lower River
As the light dances around you and you see the reflection of the flame in the water, you notice that the river just ends. You can't see where it goes. It just hits a wall and ends. You get closer to the edge of the river and you the small inner stream of blood being sucked into this glass box.  You can also see a black glimmer from the northeast.

The glass box shimmers under water like it's calling to you.

There are large amounts of moss covering the walls and floor.

>take glass box
That's fixed in place.

>x glass box
While the box is made of glass, you still are unable to make out what's inside. It looks like the box is frosted, but you can hear something clanking against the box inside. Maybe you should open the box.

>open glass box
You open the glass box, revealing a vial of Dragon's Blood.

>x vial of Dragon's Blood
As you bring it closer to you, you can more clearly see the long slender vial that the blood is in. It's topped with a cork and seems to not leak. You also notice that the blood changes color every time you take a glance at it. It goes from a vibrant red to dark maroon, to pitch black. This will make a perfect gift for Athena!

>i
You are carrying:
  a bronze shield 1
  a torch (providing light)
  a ceremonial knife
  a boat
  a dozen eggs

>take vial
Taken.

>go ne
Under Mountain
It's almost like you can feel the pressure of a large mass around you and it feels a lot darker in here than it has in other rooms. You think you've found your way under the mountain on this island. What's peculiar is that there are drawings on these walls but only if you pass your torch very close to it, but there isn't anything else in this place at all. As you're trying to look at all the drawings you find one that's unlike the others and you catch a glimpse of the black glimmer that you've seen before.

As you continue to examine the unique drawing, you recognize it as the shape of an owl.

>examine owl
You trace the lines of the owl and admire the amount of detail in it. It almost looks like it could be really here. At first you thought that it's beak was missing since a chunk of the rock was missing. You were sad that someone's art was missing a piece, but as you press the torch a bit closer, you realize that it's actually a piece of onyx in place of where the mouth should be! It was so dark that you didn't realizing anything was there!

>take onyx
You are just able to pry the onyx from the rock wall and then the whole room starts to shake. You worry for a brief second that you've just caused the mountin to cave in but you turn back towards the drawing is see it trying to wedge itself out of the rock. It finally gets free and starts flying in front of your face. You can feel that it doesn't mean any harm to you and it nods at you and flys straight through the rock. This must be a sign from the Gods that you were meant to have this!

* * *

>go up
Entrance to the Cave
You found the layer of Medusa. What will be her fate if you walk inside? Near the cave opening, you see a ladder descending down.

>go east
Atrium
What would normally be a regular living space but seems scarily empty.

>go east
Kitchen
Maybe  a better description for this room would be a slaughter room. Most likely for  sacrifice purposes, hopefully.

>go west
Atrium
What would normally be a regular living space but seems scarily empty.

>go west
You hear another loud rumbling from deep within the mountain and you see the entrance fill up with rocks. Within seconds the rocks have already reached the top. You quickly try to see if you can push or pull some rocks out and create a hole, but alas not a single rock budges. It seems to be that you're stuck in Medusa's home.

>go south
Worship Room
Many beautiful things that Athena would enjoy are housed here.

>go north
Atrium
What would normally be a regular living space but seems scarily empty.

>go down
You can't go that way.

>go up
You can't go that way.

>go east
Kitchen
Maybe  a better description for this room would be a slaughter room. Most likely for  sacrifice purposes, hopefully.

* * *

>take onyx
You are just able to pry the onyx from the rock wall and then the whole room starts to shake. You worry for a brief second that you've just caused the mountin to cave in but you turn back towards the drawing is see it trying to wedge itself out of the rock. It finally gets free and starts flying in front of your face. You can feel that it doesn't mean any harm to you and it nods at you and flys straight through the rock. This must be a sign from the Gods that you were meant to have this!

>look
Under Mountain
It's almost like you can feel the pressure of a large mass around you and it feels a lot darker in here than it has in other rooms. You think you've found your way under the mountain on this island. What's peculiar is that there are drawings on these walls but only if you pass your torch very close to it, but there isn't anything else in this place at all.

>go north
Under Cave Entrance
It felt like you climbed throught the mountain to get here, but you don't really know where here is. There really isn't anything here that you could piece together where you are, but you're probably near cave. You can see a ladder in the far corner that you can go up.

>look
Under Cave Entrance
It felt like you climbed throught the mountain to get here, but you don't really know where here is. There really isn't anything here that you could piece together where you are, but you're probably near cave. You can see a ladder in the far corner that you can go up.

>go south
Under Mountain
It's almost like you can feel the pressure of a large mass around you and it feels a lot darker in here than it has in other rooms. You think you've found your way under the mountain on this island. What's peculiar is that there are drawings on these walls but only if you pass your torch very close to it, but there isn't anything else in this place at all.

>go north
Under Cave Entrance
It felt like you climbed throught the mountain to get here, but you don't really know where here is. There really isn't anything here that you could piece together where you are, but you're probably near cave. You can see a ladder in the far corner that you can go up.

>go south
Under Mountain
It's almost like you can feel the pressure of a large mass around you and it feels a lot darker in here than it has in other rooms. You think you've found your way under the mountain on this island. What's peculiar is that there are drawings on these walls but only if you pass your torch very close to it, but there isn't anything else in this place at all.

* * *

>go north
Under Cave Entrance
It felt like you climbed throught the mountain to get here, but you don't really know where here is. There really isn't anything here that you could piece together where you are, but you're probably near cave. You can see a ladder in the far corner that you can go up.

>go up
Entrance to the Cave
You found the layer of Medusa. What will be her fate if you walk inside? Near the cave opening, you see a ladder descending down.

* * *

>go east
Atrium
What would normally be a regular living space but seems scarily empty.

>look
Atrium
What would normally be a regular living space but seems scarily empty.

>go west
You hear another loud rumbling from deep within the mountain and you see the entrance fill up with rocks. Within seconds the rocks have already reached the top. You quickly try to see if you can push or pull some rocks out and create a hole, but alas not a single rock budges. It seems to be that you're stuck in Medusa's home.
An avalanche of rocks is blocking that path.

>go east
Kitchen
Maybe  a better description for this room would be a slaughter room. Most likely for  sacrifice purposes, hopefully.

>go west
Atrium
What would normally be a regular living space but seems scarily empty.

1

>go west
You hear another loud rumbling from deep within the mountain and you see the entrance fill up with rocks. Within seconds the rocks have already reached the top. You quickly try to see if you can push or pull some rocks out and create a hole, but alas not a single rock budges. It seems to be that you're stuck in Medusa's home.
An avalanche of rocks is blocking that path.

2

>go east
Kitchen
Maybe  a better description for this room would be a slaughter room. Most likely for  sacrifice purposes, hopefully.

3

>go west
Atrium
What would normally be a regular living space but seems scarily empty.

4

>go west
You hear another loud rumbling from deep within the mountain and you see the entrance fill up with rocks. Within seconds the rocks have already reached the top. You quickly try to see if you can push or pull some rocks out and create a hole, but alas not a single rock budges. It seems to be that you're stuck in Medusa's home.
An avalanche of rocks is blocking that path.

5

* * *

>go up
Entrance to the Cave
You found the layer of Medusa. What will be her fate if you walk inside? Near the cave opening, you see a ladder descending down.

>go down
Under Cave Entrance
It felt like you climbed throught the mountain to get here, but you don't really know where here is. There really isn't anything here that you could piece together where you are, but you're probably near cave. You can see a ladder in the far corner that you can go up.

>go up
Entrance to the Cave
You found the layer of Medusa. What will be her fate if you walk inside? Near the cave opening, you see a ladder descending down.

>go west
You can't go that way.

>go east
Atrium
What would normally be a regular living space but seems scarily empty. Medusa doesn't strike me as a poor commoner. Why doesn't she have more things?

There's a plain, rectangular, woolen rug on the floor.

There's an open hearth fireplace with a pile of wood in it

1 "Shit!" you just heard someone scream and the sound of something clattering. The voice definitely did not sound like a woman's. That man must be here! You have to get to Medusa first and stop Perseus!!

>go west
You hear another loud rumbling from deep within the mountain and you see the entrance fill up with rocks. Within seconds the rocks have already reached the top. You quickly try to see if you can push or pull some rocks out and create a hole, but alas not a single rock budges. It seems to be that you're stuck in Medusa's home.

2 You can still hear him clattering into everything and not caring about the state of this home. You still haven't seen him yet or Medusa. He seems to be getting closer to where you are.

>go east
Kitchen
Like most of the other rooms, this one too is sparse. There's no decoration or anything like that and there are barely any kitchen tools either.

There are some large pots in one corner.

There's an empty firepit in the middle of the room.

3 You can still hear him clattering into everything and not caring about the state of this home. You still haven't seen him yet or Medusa. He seems to be getting closer to where you are.

>go west
Atrium
What would normally be a regular living space but seems scarily empty. Medusa doesn't strike me as a poor commoner. Why doesn't she have more things?

There's a plain, rectangular, woolen rug on the floor.

There's an open hearth fireplace with a pile of wood in it

4 You can still hear him clattering into everything and not caring about the state of this home. You still haven't seen him yet or Medusa. He seems to be getting closer to where you are.

>go west
An avalanche of rocks is blocking that path.

5 You hear Perseus footsteps quickening. Has he heard you?? Has he found Medusa?? He seems to be getting ever so closer to where you are and you still haven't found Medusa!

>look
Atrium
What would normally be a regular living space but seems scarily empty. Medusa doesn't strike me as a poor commoner. Why doesn't she have more things?

There's a plain, rectangular, woolen rug on the floor.

There's an open hearth fireplace with a pile of wood in it

6 You hear Perseus footsteps quickening. Has he heard you?? Has he found Medusa?? He seems to be getting ever so closer to where you are and you still haven't found Medusa!

>go east
Kitchen
Like most of the other rooms, this one too is sparse. There's no decoration or anything like that and there are barely any kitchen tools either.

There are some large pots in one corner.

There's an empty firepit in the middle of the room.

7 You hear Perseus footsteps quickening. Has he heard you?? Has he found Medusa?? He seems to be getting ever so closer to where you are and you still haven't found Medusa!

>go northeast
Bedroom 2
A completely unused room. I guess Medusa never had any guests or family that wanted to stay over. Maybe she had no friends or family...Maybe she was forced away from them...

The chest in the room seems to be bolted shut.

Here's a bed with no bedding.

8 You hear Perseus footsteps quickening. Has he heard you?? Has he found Medusa?? He seems to be getting ever so closer to where you are and you still haven't found Medusa!

>go northwest
Treasure Room
The room is filled with gold. I don't know how anyone could have aquired this much gold. A dragon would be jealous of all of this gold, but one of these things is not like the others and you see a glimmer of bronze behind a pile of jewlery. 

You can see a pile of jewlery, a pile of coins and a pile of medals here.

9 You hear Perseus footsteps quickening. Has he heard you?? Has he found Medusa?? He seems to be getting ever so closer to where you are and you still haven't found Medusa!

>examine pile of jewlery
This is a massively large pile of necklaces, bracelets, and earings. The mind boggling thing is that they all look unique. No two pieces of jewlery look a like. Some even have gems in them. As you step closer, you can see the bronze shield wedged into that pile That you could definitely take.

>take bronze shield
(the bronze shield 3)
"You can't escape from me Medusa!! Your reign of terror is over!!!" you here Perseus shout! It feels like he's two rooms away. You have to pick of the pace if you want to find Medusa first!!

>go se
Bedroom 2
A completely unused room. I guess Medusa never had any guests or family that wanted to stay over. Maybe she had no friends or family...Maybe she was forced away from them...

The chest in the room seems to be bolted shut.

Here's a bed with no bedding.

You can hear him scrapping his sword against the wall and say with the utmost confidence, "You can run but you can't hide Medusa! I will find you!!" You hope he hasn't heard you and you still have the element of surprise, but he sounds slightly closer. You need to pick up the pace!!

>go sw
Kitchen
Like most of the other rooms, this one too is sparse. There's no decoration or anything like that and there are barely any kitchen tools either.

There are some large pots in one corner.

There's an empty firepit in the middle of the room.

"I can hear you! I've got you now Medusa! Prepare to meet your fate you disgraceful monster!" you hear Perseus cry, but the most distressing part is that he sounds like he's just in the next room. You need to hurry!!

>sw
Worship Room
Again the room is sparse but the walls are breathtaking. The murals are the most intricate you've ever seen, and every single one of them details a story about Athena. Medusa was nothing if not dedicated. There isn't a single other thing in this room.

It really feels like the magic of the Goddess Athena is coursing throught the murals.

"Your ass is mine now you fucking shameful slut!" Perseus screams. You see him in one the doorways, but you can't see Medusa anywhere?? Maybe she's in the very next room! You're not sure if Perseus saw you or cares that you're there but you still have to try to help Medusa!

* * *

>buy boat
Nothing is on sale.

* * *

>go west
Agora
You walk into a bustling marketplace with three major vendors. Hopefully you can find some useful items here. There seem to be three pretty well established vendors here to the north, west, and south.

>go east
Town Center
You're back to the beautiful courtyard dirt roads, beautiful foliage, river near the north, mountains near the northeast and some kind of buildings near the east. It seems like something is different since the last time you were here. Perhaps you should look a bit closer and see what's here.

>go west
Agora
You walk into a bustling marketplace with three major vendors. Hopefully you can find some useful items here. There seem to be three pretty well established vendors here to the north, west, and south.

* * *

>go east
Town Center
You're back to the beautiful courtyard dirt roads, beautiful foliage, river near the north, mountains near the northeast and some kind of buildings near the east. It seems like something is different since the last time you were here. Perhaps you should look a bit closer and see what's here.

>look
Town Center
You wake up not quite being able to remember anything from before this moment. All you remember is that you're Greek and you live on an island called Sarpedon. You look around you and notice dirt roads and beauitful foliage all around and a calmly flowing river to the north. The mountains near the northeast frame this beautiful landscape and you can sort of see some kind of buildings near the east. To the west you hear the bustling noise of what is most likely people trading, and to the south you see the architectural marvel of the temple of Athena.

One of the beautiful ripe apples fell down! Now you can take it.

There's a lyre laying against a wall. Calling out to you to play it since its owner is nowhere to be found.

Specifically among the foliage, you spot an apple tree with delicious apples ripe for the picking! Maybe one will fall soon.

Behind a corner you spot a hole in the ground that you can probably fit down into.

>take apple
Which do you mean, the fallen apple or the apple tree?

* * *

>go west
Agora
You walk into a bustling marketplace with three major vendors. Hopefully you can find some useful items here. There seem to be three pretty well established vendors here to the north, west, and south.

>go north
Vendor 1
You walk up to a stand where a burly man and his wife show you all the neat woodworking and ceramic items they've made and have to sell. Well at least you assume the small, toned lady made some of these items. You're not actually sure. There are many beautiful wooden sculptures here that you don't think the burly man hand the patience or delicacy to make, but he treats the woman like a lowly shop hand. You wish you could make her situation better. Maybe buying something of hers would be good. You could start by exmaning some of her goods.

You can see plates, axes, knives, pots, vases and large vessels here.

>take knife
You can't see any such thing.

>take ceremonial knife
You can't see any such thing.

>examine knives
You're not very fond of weapons, but the knives catch your eyes because they're breathtaking. You walk a bit closer to them and you can see the reflection of the woman perfectly and colors dance across her skin. You might as well be entraced. These might even be made from gems and not just metal. You and the other priestesses have been thinking about getting a new ceremonial knife.

>take ceremonial knife
You don't know how much this costs and they look too well crafted for the items you have. You decide to leave it.

>south
Agora
You walk into a bustling marketplace with three major vendors. Hopefully you can find some useful items here. There seem to be three pretty well established vendors here to the north, west, and south.

>east
Town Center
You're back to the beautiful courtyard dirt roads, beautiful foliage, river near the north, mountains near the northeast and some kind of buildings near the east. It seems like something is different since the last time you were here. Perhaps you should look a bit closer and see what's here.

>look
Town Center
You wake up not quite being able to remember anything from before this moment. All you remember is that you're Greek and you live on an island called Sarpedon. You look around you and notice dirt roads and beauitful foliage all around and a calmly flowing river to the north. The mountains near the northeast frame this beautiful landscape and you can sort of see some kind of buildings near the east. To the west you hear the bustling noise of what is most likely people trading, and to the south you see the architectural marvel of the temple of Athena.

There's a lyre laying against a wall. Calling out to you to play it since its owner is nowhere to be found.

Specifically among the foliage, you spot an apple tree with delicious apples ripe for the picking! Maybe one will fall soon.

Behind a corner you spot a hole in the ground that you can probably fit down into.

>west
Agora
You walk into a bustling marketplace with three major vendors. Hopefully you can find some useful items here. There seem to be three pretty well established vendors here to the north, west, and south.

>east
Town Center
You're back to the beautiful courtyard dirt roads, beautiful foliage, river near the north, mountains near the northeast and some kind of buildings near the east. It seems like something is different since the last time you were here. Perhaps you should look a bit closer and see what's here.

* * *

>west
Agora
You walk into a bustling marketplace with three major vendors. Hopefully you can find some useful items here. There seem to be three pretty well established vendors here to the north, west, and south.

* * *

>east
Town Center
You're back to the beautiful courtyard dirt roads, beautiful foliage, river near the north, mountains near the northeast and some kind of buildings near the east. It seems like something is different since the last time you were here. Perhaps you should look a bit closer and see what's here.

>west
Agora
You walk into a bustling marketplace with three major vendors. Hopefully you can find some useful items here. There seem to be three pretty well established vendors here to the north, west, and south.

>north
Vendor 1
You walk up to a stand where a burly man and his wife show you all the neat woodworking and ceramic items they've made and have to sell. Well at least you assume the small, toned lady made some of these items. You're not actually sure. There are many beautiful wooden sculptures here that you don't think the burly man hand the patience or delicacy to make, but he treats the woman like a lowly shop hand. You wish you could make her situation better. Maybe buying something of hers would be good. You could start by exmaning some of her goods.

You can see a ceremonial knife, plates, axes, knives, pots, vases and large vessels here.

>take ceremonial knife
You don't know how much this costs and they look too well crafted for the items you have. You decide to leave it.

* * *

>take ceremonial knife
Kind woman, thank you for such interest in my wares! It pleases me to know that people like my craftswork!

Taken.

* * *

>go west
Agora
You walk into a bustling marketplace with three major vendors. Hopefully you can find some useful items here. There seem to be three pretty well established vendors here to the north, west, and south.

>go south
Vendor 3
You really want to avoid this cart because the man running it seems to really hate you, and for what!? You just got here! He has a bunch of food and clothing though and that could be really useful.

You can see olives, bundles of wheat, a dozen eggs, figs, vases of milk, grapes and lentils here.

>x olives
You see a bunch of olives in a basket. There are olives all around this area though, so you're not sure they'll be worth much in a trade.

>x bundles
There's a small pyramid of bundles of wheat on the counter top, and there's only one wheat farm on this island. Wheat would probably be very valuable as a trading item to buy.

>take bundles
You've purchased some bundles of wheat, and left some coins on the counter.

Taken.

>x eggs
Rarely are there good eggs on this island, and that basket of 12 eggs looks really great. This would probably be a good trading item to buy.

>take eggs
You've purchased a dozen eggs, and left some coins on the counter.

Taken.

>x figs
You don't remember if you like figs but you've seen them on the trees walking around this town, so they may not be a very good trading item to buy.

>x milk
There are three vary large vases of milk and you're not sure you could actually carry those vases.

>take milk
You really can't lift these vases so you'll have to buy something else.

>x grapes
There is an abundance of grapes in baskets at this stand and  because of their abundace in the region, they might not be a good trade item to buy.

>take grapes
You only have a limited amount of money so you decide to leave the grapes and buy something you think would be useful to trade with.

>x lentils
This legume can be used for both food and fodder. Because of this duality, it would be a good trade item to buy.

>take lentils
You've purchases some lentils, and left some coins on the counter.

Taken.

>i
You are carrying:
  lentils
  a dozen eggs
  bundles of wheat
  a sack of coins

* * *

>i
You are carrying:
  lentils
  a dozen eggs
  bundles of wheat

>go north
Vendor 1
You walk up to a stand where a burly man and his wife show you all the neat woodworking and ceramic items they've made and have to sell. Well at least you assume the small, toned lady made some of these items. You're not actually sure. There are many beautiful wooden sculptures here that you don't think the burly man hand the patience or delicacy to make, but he treats the woman like a lowly shop hand. You wish you could make her situation better. Maybe buying something of hers would be good.

You can see plates, axes, knives, pots, vases and large vessels here.

>x plates
You see nothing special about plates.

>x axes
You see nothing special about axes.

>x pots
You see nothing special about pots.

>x vases
You see nothing special about vases.

>x large vessels
You're intrigued by the large vessels try to see if you can find something of use, so you flag the woman over.

The woman comes up to you and points out that hidden small-ish boat behind some large vases and fishing boats. "I made this boat myself!" she says. She looks around and makes sure her husband is occupied with something else and whispers, "My husband over there doesn't like when I make things like he does, but I've always been drawn to it. I think once I sell it he won't be as irate anymore. Would you like to buy it? I'll accept 3 bundles of wheat. It would really mean a lot to me!"

>look
Vendor 1
You walk up to a stand where a burly man and his wife show you all the neat woodworking and ceramic items they've made and have to sell. Well at least you assume the small, toned lady made some of these items. You're not actually sure. There are many beautiful wooden sculptures here that you don't think the burly man hand the patience or delicacy to make, but he treats the woman like a lowly shop hand. You wish you could make her situation better. Maybe buying something of hers would be good.

You can see a boat, plates, axes, knives, pots, vases and large vessels here.

>take boat
Thank you kind woman for your wheat! May this boat be blessed by Athena herself for safe travels! Speaking of Athena, it really is a shame that one of her priestesses disgraced the temple like that! Where did she go getting such an idea! Anyways, have a good day and come back real soon!

>go s
Agora
You walk into a bustling marketplace with three major vendors. Hopefully you can find some useful items here. There seem to be three pretty well established vendors here to the north, west, and south.

* * *

>look
Town Center
You're back to the beautiful courtyard dirt roads, beautiful foliage, river near the north, mountains near the northeast, some kind of buildings near the east, the bustling marketplace near the west, and the marvelous Temple of Athena to the south

There's a lyre laying against a wall. Calling out to you to play it since its owner is nowhere to be found.

Specifically among the foliage, you spot an apple tree with delicious apples ripe for the picking! Maybe one will fall soon.

Behind a corner you spot a hole in the ground that you can probably fit down into.

>go west
Agora
You walk into a bustling marketplace with three major vendors. Hopefully you can find some useful items here. There seem to be three pretty well established vendors here to the north, west, and south.

* * *

>i
You are carrying:
  a boat
  lentils
  a dozen eggs

* * *

>take coins
Now the coins are in your inventory (i).

>go down
Darkness
It is pitch dark, and you can't see a thing.

>go north
As you get closer you notice that the river is flowing in from above as well creating a powerful waterfall! It's still quite a ways wide and you never now how deep a river could be! You decide to hang back until you can find something to help you navigate it.

>go north
As you get closer you notice that the river is flowing in from above as well creating a powerful waterfall! It's still quite a ways wide and you never now how deep a river could be! You decide to hang back until you can find something to help you navigate it.

>go west
Darkness
It is pitch dark, and you can't see a thing.

>go up
You can't go that way.

>go east
Darkness
It is pitch dark, and you can't see a thing.

>go up
Town Center
You're back to the beautiful courtyard dirt roads, beautiful foliage, river near the north, mountains near the northeast, some kind of buildings near the east, the bustling marketplace near the west, and the marvelous Temple of Athena to the south

There's a lyre laying against a wall. Calling out to you to play it since its owner is nowhere to be found.

Specifically among the foliage, you spot an apple tree with delicious apples ripe for the picking! Maybe one will fall soon.

Behind a corner you spot a hole in the ground that you can probably fit down into.

>go east
This appears to be a gated community of sorts and the guard won't let you through with out the proper documents.

>go north
As you get closer you notice that the river is flowing a lot harsher than you thought. It's quite a ways wide and you never now how deep a river could be! You decide to hang back until you can find something to help you navigate it.

>go west
Agora
You walk into a bustling marketplace with three major vendors. Hopefully you can find some useful items here. There seem to be three pretty well established vendors here to the north, west, and south.

>north
Vendor 1
You walk up to a stand where a burly man and his wife show you all the neat woodworking and ceramic items they've made and have to sell. Well at least you assume the small, toned lady made some of these items. You're not actually sure. There are many beautiful wooden sculptures here that you don't think the burly man hand the patience or delicacy to make, but he treats the woman like a lowly shop hand. You wish you could make her situation better. Maybe buying something of hers would be good.

You can see plates, axes, knives, pots, vases and large vessels here.

>buy plate
You can't see any such thing.

>buy plates
You don't have the trade item needed to get the plates, but you probably won't need it.

>buy vesseles
You can't see any such thing.

>vessels
That's not a verb I recognise.

>buy vessels
Taken.

>buy vases
You don't have the trade item needed to get the vases, but you probably won't need it.

>check i
You can't see any such thing.

>i
You are carrying:
  large vessels
  a sack of coins

>go s
Agora
You walk into a bustling marketplace with three major vendors. Hopefully you can find some useful items here. There seem to be three pretty well established vendors here to the north, west, and south.

>go w
Vendor 2
You almost trip walking up to this stand because the vendor is so beautiful and you literally stopped paying attention to where you were going.  To quickly try to impress her, you take stock of what she's selling and try to find an interesting fact that you know. If only you could remember anything about plants and herbs! If only you remembered to stop walking instead of being drawn ever so closer and bumping into her cart! You also notice a small trap door leading down somewhere. next to the side of this woman's cart.

The woman introduces herself as Antheia and it doesn't surprise you that her name is as beautiful as she is. You feel like you can ask her about anything and she would know the answer.

You can also see oregano, marjoram, fennel, mint, sideritis, chamomile and flowers here.

>help
Welcome to the Help List!

This is a list of commands that you can type in that would be useful to you in the game. If you're unsure of how to do something, or stuck at a particular point, try some of these commands and you may get some hints.

The format of this list will be  <Command>: <what the command does>. 
<object> means replace that with the actual name of the object in the command. 
<person> means replace that with the name of a person that you meet in the command. etc.

-look: will redescribe the room/place you're in and the things in it. 
-examine (x for short): will take a closer look at an object in the room/place. 
-play <object>: if the object is an instrument, this command allows you to play it. 
-take <object>: if you can take an object and carry it with you, this command will put it in your inventory so that you can keep the object on your person. You can also buy items buy using the take command. As an alternative you can use the buy command. 
-buy <object>: this allows you to buy wares from vendors. You can also use the take command. 
-drop <object>: will remove an object from your inventory and into the room/place you're in. 
-inventory (i for short): will show you all the objects you're currently carrying. 
-go <direction> (abbreviation for direction, like n for north, or just the direction for short): will take you in that direction to the next room/place The directions are North, East, South West, Northeast, Southeast, Southwest, Northwest, Up, and Down. There's no need to specify through what you think you're going through, like a hole, just writing the direction is enough! 
-ask <person> about <object>: If there's a named person, you can ask them about objects you may have learned about. 
-put <object> on <object>: will set the first object on top of the second one. 
-pray to <diety>: allows you to sacrifice a gift in order to receive wisdom from a diety in their temple. You can only pray to the diety of that temple. 
-open <object>: will open any unlocked object that is closed.

>look
Vendor 2
You almost trip walking up to this stand because the vendor is so beautiful and you literally stopped paying attention to where you were going.  To quickly try to impress her, you take stock of what she's selling and try to find an interesting fact that you know. If only you could remember anything about plants and herbs! If only you remembered to stop walking instead of being drawn ever so closer and bumping into her cart! You also notice a small trap door leading down somewhere. next to the side of this woman's cart.

The woman introduces herself as Antheia and it doesn't surprise you that her name is as beautiful as she is. You feel like you can ask her about anything and she would know the answer.

You can also see oregano, marjoram, fennel, mint, sideritis, chamomile and flowers here.

>take oregano
You don't have the trade item needed to get oregano, but you probably won't need it.

>take sidertis\
You can't see any such thing.

>take sidertis
You can't see any such thing.

>ask Antheia about trap door
There is no reply.

>ask Antheia about oregano
There is no reply.

>go down
Darkness
It is pitch dark, and you can't see a thing.

>go u
Vendor 2
You almost trip walking up to this stand because the vendor is so beautiful and you literally stopped paying attention to where you were going.  To quickly try to impress her, you take stock of what she's selling and try to find an interesting fact that you know. If only you could remember anything about plants and herbs! If only you remembered to stop walking instead of being drawn ever so closer and bumping into her cart! You also notice a small trap door leading down somewhere. next to the side of this woman's cart.

The woman introduces herself as Antheia and it doesn't surprise you that her name is as beautiful as she is. You feel like you can ask her about anything and she would know the answer.

You can also see oregano, marjoram, fennel, mint, sideritis, chamomile and flowers here.

>go e
Agora
You walk into a bustling marketplace with three major vendors. Hopefully you can find some useful items here. There seem to be three pretty well established vendors here to the north, west, and south.

>go s
Vendor 3
You really want to avoid this cart because the man running it seems to really hate you, and for what!? You just got here! He has a bunch of food and clothing though and that could be really useful.

You can see olives, bundles of wheat, a dozen eggs, figs, vases of milk, grapes and lentils here.

>take grapes
You only have a limited amount of money so you decide to leave the grapes and buy something you think would be useful to trade with.

>examine olives
You see a bunch of olives in a basket. There are olives all around this area though, so you're not sure they'll be worth much in a trade.

>examine bundles of wheat
There's a small pyramid of bundles of wheat on the counter top, and there's only one wheat farm on this island. Wheat would probably be very valuable as a trading item to buy.

>take wheat
You've purchased some bundles of wheat, and left some coins on the counter.

Taken.

>take a dozen eggs
You've purchased a dozen eggs, and left some coins on the counter.

Taken.

>take figs
You only have a limited amount of money so you decide to leave the figs and buy something you think would be useful to trade with.

>examine figs
You don't remember if you like figs but you've seen them on the trees walking around this town, so they may not be a very good trading item to buy.

>examine vases of millk
I only understood you as far as wanting to examine vases of milk.

>examine vases of milk
There are three vary large vases of milk and you're not sure you could actually carry those vases.

>go n
Agora
You walk into a bustling marketplace with three major vendors. Hopefully you can find some useful items here. There seem to be three pretty well established vendors here to the north, west, and south.

>go n
Vendor 1
You walk up to a stand where a burly man and his wife show you all the neat woodworking and ceramic items they've made and have to sell. Well at least you assume the small, toned lady made some of these items. You're not actually sure. There are many beautiful wooden sculptures here that you don't think the burly man hand the patience or delicacy to make, but he treats the woman like a lowly shop hand. You wish you could make her situation better. Maybe buying something of hers would be good.

You can see plates, axes, knives, pots and vases here.

>examine plates
Just some hand crafted wooden plates

>examine axes
Just some nice axes with a wooden handle.

>examine pots
Just some nice bronze pots.

>examine knives
You're not very fond of weapons, but the knives catch your eyes because they're breathtaking. You walk a bit closer to them and you can see the reflection of the woman perfectly and colors dance across her skin. You might as well be entraced. These might even be made from gems and not just metal. It looks like a type of ceremonial knife.

>buy knives
Taken.

>i
You are carrying:
  knives
  a dozen eggs
  bundles of wheat
  large vessels
  a sack of coins

>examine large vessels
You're intrigued by the large vessels try to see if you can find something of use, so you flag the woman over.

The woman comes up to you and points out that hidden small-ish boat behind some large vases and fishing boats. "I made this boat myself!" she says. She looks around and makes sure her husband is occupied with something else and whispers, "My husband over there doesn't like when I make things like he does, but I've always been drawn to it. I think once I sell it he won't be as irate anymore. Would you like to buy it? I'll accept 3 bundles of wheat. It would really mean a lot to me!"

>buy boat
Thank you kind woman for your wheat! May this boat be blessed by Athena herself for safe travels! Speaking of Athena, it really is a shame that one of her priestesses disgraced the temple like that! Where did she go getting such an idea! Anyways, have a good day and come back real soon!
The woman again calls after you, "Kind woman I gave you an extra gift for the pleasure of speaking with you! I noticed your interest in other wares of mine. I hope you like it!"

>i
You are carrying:
  a ceremonial knife
  a boat
  knives
  a dozen eggs
  large vessels
  a sack of coins

>go s
Agora
You walk into a bustling marketplace with three major vendors. Hopefully you can find some useful items here. There seem to be three pretty well established vendors here to the north, west, and south.

* * *

>examine oregano
Rigani in Greek. Oregano encourages good luck and good health and symbolises joy. It's good for warding off evil spirits and when worn on the head during sleep, it encourages psychic dreams.

>examine marjoram
Mantsourano in Greek. Marjoram is a symbol of happiness and love and it can be made into wreaths for newly married couples or placed on graves, to help fill the final resting place with eternal happiness and peace.

>examine fennel
Maratho in greek taken from the place named Marathon. Marjoram promotes endurance and longevity.

>examine mint
Menta in Greek. This herb was named after a water nymph named Minthe. She drew the attention of Hades and when Persphone learnt of this, she turned Minthe into an herb.

>examine sideritis
Also known as Greek Mountain Tea, the name Sideritis is derived from the word iron and is used to heal wounds caused by iron weapons. It can also be used as a tonic.

>examine chamomile
In Greek chamomile means apple of the ground because of its fresh apple scent. Hippocrates recomends chamomile for purification, protection, and to fight colds.

>examine flowers
You see nothing special about flowers.

>take flowers
Taken.

>take chamomile
Taken.

>take mint
You don't have the trade item needed to get mint, but you probably won't need it.

>take fennel
You don't have the trade item needed to get fennel, but you probably won't need it.

>go e
Agora
You walk into a bustling marketplace with three major vendors. Hopefully you can find some useful items here. There seem to be three pretty well established vendors here to the north, west, and south.

>go e
Town Center
You're back to the beautiful courtyard dirt roads, beautiful foliage, river near the north, mountains near the northeast, some kind of buildings near the east, the bustling marketplace near the west, and the marvelous Temple of Athena to the south. It seems like something is different since the last time you were here.

One of the beautiful ripe apples fell down! Now you can take it.

There's a lyre laying against a wall. Calling out to you to play it since its owner is nowhere to be found.

Specifically among the foliage, you spot an apple tree with delicious apples ripe for the picking! Maybe one will fall soon.

Behind a corner you spot a hole in the ground that you can probably fit down into.

>take apple
Which do you mean, the fallen apple or the apple tree?

>the apple tree
That's fixed in place.

>take the fallen apple
You now have an apple in your inventory (i).

>go s
Temple of Athena
As soon as you step foot within the temple you hear dramatic whisperings.

"I can't believe she would do that", a priestess said.

"What did she do?", another priestess asked.

"Oh you didn't hear? Our fellow priestess Medusa broke her vow and had sex with a man in this very temple!", exclaimed the first priestess.

The second priestess gasps loudly and says,"I can't believe she would disgrace Athena like that! How vile! How disgusting!"

They never look in your direction and walk into a different room. You then take the time to look around.

Athena deserves only the best and that's exactly what this temple is. It's pristine and made with the finest marble possible. Bits of gold and other gems make the temple sparkle with magical radiance as the sun hits it just right.

You see a prayer book, and It's a very elegant and ornate book and maybe you can find the answers you've been searching for if you read the prayer book.

You can see a book stand here.

>examine book stand
It is just a plain wooden stand with a tilted top for better reading.

On the book stand is a prayer book.

>take book stand
That's fixed in place.

>examine book
(the book stand)
It is just a plain wooden stand with a tilted top for better reading.

On the book stand is a prayer book.

>examine prayer book
You see nothing special about the prayer book.

>read prayer book
Guidelines to pray to the Goddess Athena:

Our goddess requires gifts to give us her devine thoughts. For us to get our gifts to Athena, we've built a special altar where we can place our gift and it will be burnt after you start to pray so that the smoke will rise up to our Goddess. After she is done communicating with us, she returns our gift to us in gratitude, and it won't be a pile of ashes anymore!

We've learned that some of Athena's favorite gifts are Olives, Tiger Lillies, Cinnamon, Dragonis Blood, Onyx, Star Sapphire, and Ivory. Each gift garners a different response from Athena though so it would be a great idea to get multiple gifts for a more complete answer about something.

You're not really sure where to find those gifts mentioned yet so maybe you can ask somebody in the Agora about  these gifts for help.

>i
You are carrying:
  a fallen apple: 1
  chamomile
  flowers
  a ceremonial knife
  a boat
  knives
  a dozen eggs
  large vessels
  a sack of coins

>go n
Town Center
You're back to the beautiful courtyard dirt roads, beautiful foliage, river near the north, mountains near the northeast, some kind of buildings near the east, the bustling marketplace near the west, and the marvelous Temple of Athena to the south

There's a lyre laying against a wall. Calling out to you to play it since its owner is nowhere to be found.

Specifically among the foliage, you spot an apple tree with delicious apples ripe for the picking! Maybe one will fall soon.

Behind a corner you spot a hole in the ground that you can probably fit down into.

>go w
Agora
You walk into a bustling marketplace with three major vendors. Hopefully you can find some useful items here. There seem to be three pretty well established vendors here to the north, west, and south.

>go w
Vendor 2
You almost trip walking up to this stand because the vendor is so beautiful and you literally stopped paying attention to where you were going.  To quickly try to impress her, you take stock of what she's selling and try to find an interesting fact that you know. If only you could remember anything about plants and herbs! If only you remembered to stop walking instead of being drawn ever so closer and bumping into her cart! You also notice a small trap door leading down somewhere. next to the side of this woman's cart.

The woman introduces herself as Antheia and it doesn't surprise you that her name is as beautiful as she is. You feel like you can ask her about anything and she would know the answer.

You can also see oregano, marjoram, fennel, mint and sideritis here.

>ask antheia about olives
Antheia is slient for a moment and then puts her hand on your shoulder and points you to a vendor that is southeast from her. "That vendor should have some olives for you. I know that Athena just loves olives, and I think she would love to talk to you if you had some. Sometimes the Gods speak through me," she tells you with a smile. The touch from her hand sends shivers throughout your entire body. She senses that and starts to giggle.

"Surely touch cannot be that foreign to you that you shiver in fear at the response!" she tells you with a sly smile on her face. She must know what she's doing to you.

"No no no! I just. It's not that your touch is bad or anything of that sort! In fact, I like it a lot. Maybe too much! But not in a bad way! Askgldjsalfdj, I'm just going to quit now before I ramble you into an early grave," you respond with the social grace of a dancer with no flexibility or rhythm.

"Oh? Well I implore you, please go on! It's not every day I see a beautiful girl at my store, and I want to know what you like, so that you'll come back and spend some more time with me!" she responds back. If only you could remember anything, because you can't even remember what flirting looked like or how to do it and so you don't even know how to handle yourself.

"I'm already planning on coming back! You're so sweet and you've been helping me out quite a lot!" you tell her with all the scincerity in the world.

"I'm looking forward to it gorgeous" she told you as she went to go help another customer.

>ask antheia about tiger lilly
There is no reply.

>ask antheia about tiger lily
Antheia rummages through her stock and finds you a Tiger Lily that you can buy from her for a dozen eggs. She tells you, "Are you looking to pray to Athena? If so, this is a very good, simple gift. Cinnamon is another good option! Don't be afraid to aske me any other questions. I'm certain now that the Goddesses want me to help you."

>buy eggs
You've purchased a dozen eggs, and left some coins on the counter.

You already have that.

>buy tiger lily
You now have a Tiger Lily!

>ask antheia about onyx
"This must be a serious conversation you're having with the marvelous Athena if you're trying to find all these gifts in one day!" Antheia says lightheartedly. She sees the somber tone in your face and realizes that this indeed must be of the utmost importance.

She wraps an arm around you, "Here is a torch. The onyx will also be under our very feet. It is underneath the tallest point of our city. Go make haste. You shouldn't waste any time! Go talk to Athena"

Somehow Antheia knows exactly what you need and  you are extremely grateful to her.

>ask antheia about cinnamon
Antheia rummages through her stock and finds you a vial of cinnamon that you can buy from her for some lentils. She tells you, "Are you looking to pray to Athena? If so, this is a very good, simple gift. Tiger Lillies are another good option! Don't be afraid to ask me any other questions. I feel drawn to you in a way that I don't with other people."

>go e
Agora
You walk into a bustling marketplace with three major vendors. Hopefully you can find some useful items here. There seem to be three pretty well established vendors here to the north, west, and south.

>go  s
Vendor 3
You really want to avoid this cart because the man running it seems to really hate you, and for what!? You just got here! He has a bunch of food and clothing though and that could be really useful.

You can see olives, figs, vases of milk, grapes and lentils here.

>buy lentils
You've purchases some lentils, and left some coins on the counter.

Taken.

>buy olives
This man has been very disgusted with you for no reason. He sees you touching a grape and hears you ask how much it is and declares that the whole branch must be thrown out because it's been contaminated! He throws the bunch of grapes on the floor and spits in your direction. You don't remember if you've done anything to this man, but you take the grapes on the floor any way.

Taken.

>go n
Agora
You walk into a bustling marketplace with three major vendors. Hopefully you can find some useful items here. There seem to be three pretty well established vendors here to the north, west, and south.

>go e
Town Center
You're back to the beautiful courtyard dirt roads, beautiful foliage, river near the north, mountains near the northeast, some kind of buildings near the east, the bustling marketplace near the west, and the marvelous Temple of Athena to the south. It seems like something is different since the last time you were here.

There's a lyre laying against a wall. Calling out to you to play it since its owner is nowhere to be found.

Specifically among the foliage, you spot an apple tree with delicious apples ripe for the picking! Maybe one will fall soon.

Behind a corner you spot a hole in the ground that you can probably fit down into.

You can also see a fallen apple here.

>go s
Temple of Athena
As soon as you step foot within the temple you hear dramatic whisperings.

"I can't believe she would do that", a priestess said.

"What did she do?", another priestess asked.

"Oh you didn't hear? Our fellow priestess Medusa broke her vow and had sex with a man in this very temple!", exclaimed the first priestess.

The second priestess gasps loudly and says,"I can't believe she would disgrace Athena like that! How vile! How disgusting!"

They never look in your direction and walk into a different room. You then take the time to look around.

Athena deserves only the best and that's exactly what this temple is. It's pristine and made with the finest marble possible. Bits of gold and other gems make the temple sparkle with magical radiance as the sun hits it just right.

You see a prayer book, and It's a very elegant and ornate book and maybe you can find the answers you've been searching for if you read the prayer book.

You can see a book stand here.

>pray to athena
You can't see any such thing.

>help
Welcome to the Help List!

This is a list of commands that you can type in that would be useful to you in the game. If you're unsure of how to do something, or stuck at a particular point, try some of these commands and you may get some hints.

The format of this list will be  <Command>: <what the command does>. 
<object> means replace that with the actual name of the object in the command. 
<person> means replace that with the name of a person that you meet in the command. etc.

-look: will redescribe the room/place you're in and the things in it. 
-examine (x for short): will take a closer look at an object in the room/place. 
-play <object>: if the object is an instrument, this command allows you to play it. 
-take <object>: if you can take an object and carry it with you, this command will put it in your inventory so that you can keep the object on your person. You can also buy items buy using the take command. As an alternative you can use the buy command. 
-buy <object>: this allows you to buy wares from vendors. You can also use the take command. 
-drop <object>: will remove an object from your inventory and into the room/place you're in. 
-inventory (i for short): will show you all the objects you're currently carrying. 
-go <direction> (abbreviation for direction, like n for north, or just the direction for short): will take you in that direction to the next room/place The directions are North, East, South West, Northeast, Southeast, Southwest, Northwest, Up, and Down. There's no need to specify through what you think you're going through, like a hole, just writing the direction is enough! 
-ask <person> about <object>: If there's a named person, you can ask them about objects you may have learned about. 
-put <object> on <object>: will set the first object on top of the second one. 
-pray to <diety>: allows you to sacrifice a gift in order to receive wisdom from a diety in their temple. You can only pray to the diety of that temple. 
-open <object>: will open any unlocked object that is closed.

>pray to athena
You can't see any such thing.

>read prayer book
Guidelines to pray to the Goddess Athena:

Our goddess requires gifts to give us her devine thoughts. For us to get our gifts to Athena, we've built a special altar where we can place our gift and it will be burnt after you start to pray so that the smoke will rise up to our Goddess. After she is done communicating with us, she returns our gift to us in gratitude, and it won't be a pile of ashes anymore!

We've learned that some of Athena's favorite gifts are Olives, Tiger Lillies, Cinnamon, Dragonis Blood, Onyx, Star Sapphire, and Ivory. Each gift garners a different response from Athena though so it would be a great idea to get multiple gifts for a more complete answer about something.

You're not really sure where to find those gifts mentioned yet so maybe you can ask somebody in the Agora about  these gifts for help.

>pray to athena
You can't see any such thing.

>go n
Town Center
You're back to the beautiful courtyard dirt roads, beautiful foliage, river near the north, mountains near the northeast, some kind of buildings near the east, the bustling marketplace near the west, and the marvelous Temple of Athena to the south

There's a lyre laying against a wall. Calling out to you to play it since its owner is nowhere to be found.

Specifically among the foliage, you spot an apple tree with delicious apples ripe for the picking! Maybe one will fall soon.

Behind a corner you spot a hole in the ground that you can probably fit down into.

>go s
Temple of Athena
As soon as you step foot within the temple you hear dramatic whisperings.

"I can't believe she would do that", a priestess said.

"What did she do?", another priestess asked.

"Oh you didn't hear? Our fellow priestess Medusa broke her vow and had sex with a man in this very temple!", exclaimed the first priestess.

The second priestess gasps loudly and says,"I can't believe she would disgrace Athena like that! How vile! How disgusting!"

They never look in your direction and walk into a different room. You then take the time to look around.

Athena deserves only the best and that's exactly what this temple is. It's pristine and made with the finest marble possible. Bits of gold and other gems make the temple sparkle with magical radiance as the sun hits it just right.

You see a prayer book, and It's a very elegant and ornate book and maybe you can find the answers you've been searching for if you read the prayer book.

You can see a book stand here.

>go s
Statue of Athena
A very simplistic room. There's not much in it, but there doesn't need to be. The building material is beautiful in and of its self, and this accentuates the other things in the room. You also notice a staircase that leads down near the back of this room.

A towering marble statue of Athena looms above you and you wonder how something so rigid like marble can look so fluid like cloth.

There's a wide block with a dip in the center that looks slightly singed in front of the statue. This must be the altar.

It feels like the Goddess Athena herself is present

>pray to athena
You have not brought a gift for Athena, and therefore she will not answer you.

>put olives, cinnamon, tiger lily on alter
You can't see any such thing.

>put olives, cinnamon, tiger lily on altar
You can't see any such thing.

>put olives on altar
You put olives on the altar.

>put cinnamon on altar
You can't see any such thing.

>pray to athena
The olives start to burn as soon as you started to play and the fire doesn't feel from this world because the fire is green. You can hear Athena's voice inside your head.

"You've heard about the priestess that defiled this temple. Well my child, Medusa was not at fault. The circumstances are not what you've heard...."

You feel the presence of Athena leave your head.

>place tiger lily on altar
That's not a verb I recognise.

>put cinnamon on altar
You can't see any such thing.

>put cinnammon on altar
You can't see any such thing.

>i
You are carrying:
  lentils
  a torch (providing light)
  a tiger lily
  chamomile
  flowers
  a ceremonial knife
  a boat
  knives
  large vessels
  a sack of coins

>put tiger lily on altar
You put the tiger lily on the altar.

>pray to athena
The olives start to burn as soon as you started to play and the fire doesn't feel from this world because the fire is green. You can hear Athena's voice inside your head.

"You've heard about the priestess that defiled this temple. Well my child, Medusa was not at fault. The circumstances are not what you've heard...."

You feel the presence of Athena leave your head.  The Tiger Lily shrinks into the lime green fire. The sweet scent still hits your nose, and Athena's voice is back inside your head.

"Ah my child, thank you for such a beautiful gift. Those circumstances with Medusa, they were terrible and vile and it fills me up with rage! My daughter, my fellow God," she told you with disgust," Posiedon forced himself on my priestess Medusa. She fought the whole way but she of course was no match for him. He and Zeus had the nerve to force me to discipline her for being an unwilling part of this defiling this temple...."

In anger, Athena's presence left your head.

>i
You are carrying:
  lentils
  a torch (providing light)
  chamomile
  flowers
  a ceremonial knife
  a boat
  knives
  large vessels
  a sack of coins

>go d
Under Statue
The light from the staircase near the end of the room barely sheds any light into this room, however, because of the staircase you do realize that you are under the room contain the great statue of Athena and that beaultiful altar. With the torch, you can see that these walls are covered in murals that depict the stories of Athena. Such beautiful art just hidden away and used as a kind of storage space. It is really ashame. 

You can see a wooden chest, Old books and Rusted Knives here.

>examine wooden chest
As you step closer to the open, worn out, wooden chest and notice the collection of jems inside.

>examine jems
You can't see any such thing.

>examine collection of jems
You can't see any such thing.

* * *

>take coins
Now the coins are in your inventory (i).

>go south
Temple of Athena
As soon as you step foot within the temple you hear dramatic whisperings.

"I can't believe she would do that", a priestess said.

"What did she do?", another priestess asked.

"Oh you didn't hear? Our fellow priestess Medusa broke her vow and had sex with a man in this very temple!", exclaimed the first priestess.

The second priestess gasps loudly and says,"I can't believe she would disgrace Athena like that! How vile! How disgusting!"

They never look in your direction and walk into a different room. You then take the time to look around.

Athena deserves only the best and that's exactly what this temple is. It's pristine and made with the finest marble possible. Bits of gold and other gems make the temple sparkle with magical radiance as the sun hits it just right. You can see the magnificent statue of Athena and what looks like an altar to the south.

You see a prayer book, and It's a very elegant and ornate book and maybe you can find the answers you've been searching for if you read the prayer book.

You can see a book stand here.

* * *

>pray to Athena
You can't see any such thing.

>pray
(to yourself)
You have not brought a gift for Athena, and therefore she will not answer you. Check the Prayer Book or the help list if you're unsure of how to pray.
You must pray at the altar in the Temple of Athena. Check the Prayer Book or the help list if you're unsure of how to pray.

>south
Statue of Athena
A very simplistic room. There's not much in it, but there doesn't need to be. The building material is beautiful in and of its self, and this accentuates the other things in the room. You also notice a staircase that leads down near the back of this room.

A towering marble statue of Athena looms above you and you wonder how something so rigid like marble can look so fluid like cloth.

There's a wide block with a dip in the center that looks slightly singed in front of the statue. This must be the altar.

It feels like the Goddess Athena herself is present

>pray
(to Athena)
You have not brought a gift for Athena, and therefore she will not answer you. Check the Prayer Book or the help list if you're unsure of how to pray.

* * *

>help
Welcome to the Help List!

This is a list of commands that you can type in that would be useful to you in the game. If you're unsure of how to do something, or stuck at a particular point, try some of these commands and you may get some hints.

The format of this list will be  <Command>: <what the command does>. 
<object> means replace that with the actual name of the object in the command. 
<person> means replace that with the name of a person that you meet in the command. etc.
-look: will redescribe the room/place you're in and the things in it. 
-examine (x for short): will take a closer look at an object in the room/place. 
         eg. examine plates 
-play <object>: if the object is an instrument, this command allows you to play it. 
         eg. play guitar 
-take <object>: if you can take an object and carry it with you, this command will put it in your inventory so that you can keep the object on your person. You can also buy items buy using the take command. As an alternative you can use the buy command. 
         eg. take stool 
-buy <object>: this allows you to buy wares from vendors. You can also use the take command. 
         eg. buy peaches 
-drop <object>: will remove an object from your inventory and into the room/place you're in. 
         eg. drop candle 
-inventory (i for short): will show you all the objects you're currently carrying. 
-go <direction> (abbreviation for direction, like n for north, or just the direction for short): will take you in that direction to the next room/place The directions are North, East, South West, Northeast, Southeast, Southwest, Northwest, Up, and Down. There's no need to specify through what you think you're going through, like a hole, just writing the direction is enough! 
          eg. go down 
-ask <person> about <object>: If there's a named person, you can ask them about objects you may have learned about. 
          eg. ask Bob about the eggs 
-put <object> on <object>: will set the first object on top of the second one. 
         eg. put cup on the table 
-pray to <diety>: allows you to sacrifice a gift in order to receive wisdom from a diety in their temple. To pray you must put a gift on the altar first. You can only pray to the diety of that temple, and you can only pray to that diety at the altar. 
         eg. pray to Venus, or just pray 
-open <object>: will open any unlocked object that is closed. 
         eg. open box

>play lyre
You play a beautiful melody and even sing a bit. It was so touching that some towns folk have given you a couple pieces of gold. You might as well take the coins and head towards the marketplace!

>take coins
Now the coins are in your inventory (i).

* * *

>go north
Vendor 1
You walk up to a stand where a burly man and his wife show you all the neat woodworking and ceramic items they've made and have to sell. Well at least you assume the small, toned lady made some of these items. You're not actually sure. There are many beautiful wooden sculptures here that you don't think the burly man hand the patience or delicacy to make, but he treats the woman like a lowly shop hand. You wish you could make her situation better. Maybe buying something of hers would be good.

You can see plates, axes, knives, pots, vases and large vessels here.

>x knives
You're not very fond of weapons, but the knives catch your eyes because they're breathtaking. You walk a bit closer to them and you can see the reflection of the woman perfectly and colors dance across her skin. You might as well be entraced. These might even be made from gems and not just metal. You and the other priestesses have been thinking about getting a new ceremonial knife.

* * *

>examine me
You can see that you're wearing a full length piece of wool draped over you and pinned around the waist. You can't really seem to remember how you got into this outfit or what it is, but it seems to be what everyone else is wearing. You're also wearing a wide brimmed hat that seems to have a kind of scarf draped around it protecting your neck from the harsh sun.

>go east
This appears to be a gated community of sorts and the guard won't let you through with out the proper documents.

Maybe you could ask someone in the Agora to help you find something that will help you get in.

>go west
Agora
You walk into a bustling marketplace but quickly realize that you don't have anything to trade with! Maybe you can find something back in the Town Center.

* * *

>go east
Town Center
You're back to the beautiful courtyard dirt roads, beautiful foliage, river near the north, mountains near the northeast, some kind of buildings near the east, the bustling marketplace near the west, and the marvelous Temple of Athena to the south

There's a lyre laying against a wall. Calling out to you to play it since its owner is nowhere to be found.

Specifically among the foliage, you spot an apple tree with delicious apples ripe for the picking! Maybe one will fall soon.

Behind a corner you spot a hole in the ground that you can probably fit down into.

>play lyre
You play a beautiful melody and even sing a bit. It was so touching that some towns folk have given you a couple pieces of gold, which will probably only get you three things at the marketplace. You might as well take the coins and head towards there!

>look
Town Center
You're back to the beautiful courtyard dirt roads, beautiful foliage, river near the north, mountains near the northeast, some kind of buildings near the east, the bustling marketplace near the west, and the marvelous Temple of Athena to the south

On the ground in front of your feet you can see gold coins tossed at you from when you played the lyre. This will probably be enough to buy three things.

There's a lyre laying against a wall. Calling out to you to play it since its owner is nowhere to be found.

Specifically among the foliage, you spot an apple tree with delicious apples ripe for the picking! Maybe one will fall soon.

Behind a corner you spot a hole in the ground that you can probably fit down into.

>take coins
Now the coins are in your inventory (i).

* * *

>i
You are carrying:
  a sack of coins

>take lyre
It doesn't seem to be as heavy as a bag a large rocks, but it is and you can't lift it! Perhaps it's magic

>go west
Agora
You walk into a bustling marketplace with three major vendors. Hopefully you can find some useful items here. There seem to be three pretty well established vendors here to the north, west, and south.

>go north
Vendor 1
You walk up to a stand where a burly man and his wife show you all the neat woodworking and ceramic items they've made and have to sell. Well at least you assume the small, toned lady made some of these items. You're not actually sure. There are many beautiful wooden sculptures here that you don't think the burly man has the patience or delicacy to make, but he treats the woman like a lowly shop hand. You wish you could make her situation better. Maybe buying something of hers would be good.

You can see plates, axes, knives, pots, vases and large vessels here.

>examine plates
Just some hand crafted wooden plates

* * *

>examine axes
Just some nice axes with a wooden handle.

>examine knives
You're not very fond of weapons, but the knives catch your eyes because they're breathtaking. You walk a bit closer to them and you can see the reflection of the woman perfectly and colors dance across her skin. You might as well be entraced. These might even be made from gems and not just metal. It looks like a type of ceremonial knife.

 It's always good to look at your surroundings again in case something changed!

>look
Vendor 1
You walk up to a stand where a burly man and his wife show you all the neat woodworking and ceramic items they've made and have to sell. Well at least you assume the small, toned lady made some of these items. You're not actually sure. There are many beautiful wooden sculptures here that you don't think the burly man has the patience or delicacy to make, but he treats the woman like a lowly shop hand. You wish you could make her situation better. Maybe buying something of hers would be good.

You can see a ceremonial knife, plates, axes, knives, pots, vases and large vessels here.

>examine ceremonial knife
This is the most intricate knife you at this vendor. In fact, you can see gold welded into it. It's stunning and the blade looks like the midnight sky. You ask the woman how much this is and she says, "Well for you I'll trade it for five apples!"

* * *

>examine self
You can see that you're wearing a full length piece of wool draped over you and pinned around the waist. You can't really seem to remember how you got into this outfit or what it is, but it seems to be what everyone else is wearing. You're also wearing a wide brimmed hat that seems to have a kind of scarf draped around it protecting your neck from the harsh sun.